video_id,labeler_2,labeler_1,start_seconds,end_seconds,duration
GG7IByPZKec,cutting,cutting,138,153,15
GG7IByPZKec,cutting,tying,270,278,8
GG7IByPZKec,tying,tying,290,303,13
GG7IByPZKec,suturing,suturing,235,246,11
GG7IByPZKec,tying,suturing,247,252,5
GG7IByPZKec,suturing,suturing,253,268,15
mvYF35gw4Og,cutting,cutting,16,21,5
mvYF35gw4Og,suturing,suturing,83,91,8
K41gnfWPuhE,cutting,cutting,1,13,12
K41gnfWPuhE,cutting,cutting,30,55,25
K41gnfWPuhE,cutting,cutting,66,232,166
K41gnfWPuhE,cutting,cutting,246,290,44
dBRV4qa_qxk,,cutting,11,15,4
dBRV4qa_qxk,cutting,cutting,53,60,7
dBRV4qa_qxk,cutting,cutting,61,69,8
dBRV4qa_qxk,cutting,cutting,70,109,39
dBRV4qa_qxk,cutting,cutting,118,151,33
dBRV4qa_qxk,,cutting,204,206,2
dBRV4qa_qxk,cutting,cutting,285,294,9
dBRV4qa_qxk,tying,tying,163,168,5
dBRV4qa_qxk,suturing,tying,169,174,5
dBRV4qa_qxk,tying,tying,175,187,12
dBRV4qa_qxk,suturing,suturing,152,162,10
dBRV4qa_qxk,suturing,suturing,244,255,11
dBRV4qa_qxk,none,suturing,256,261,5
dBRV4qa_qxk,suturing,suturing,262,271,9
uVvBlWpwopw,,cutting,32,140,108
_B0S8vqgKT8,cutting,cutting,281,290,9
_B0S8vqgKT8,cutting,cutting,364,376,12
_B0S8vqgKT8,tying,tying,410,432,22
_B0S8vqgKT8,tying,tying,487,500,13
_B0S8vqgKT8,tying,tying,521,526,5
_B0S8vqgKT8,tying,tying,555,564,9
_B0S8vqgKT8,suturing,suturing,148,179,31
_B0S8vqgKT8,,suturing,183,186,3
_B0S8vqgKT8,suturing,suturing,206,244,38
_B0S8vqgKT8,suturing,suturing,469,484,15
_B0S8vqgKT8,suturing,suturing,508,520,12
_B0S8vqgKT8,suturing,suturing,541,554,13
VFyJ65hEF3k,cutting,cutting,66,74,8
VFyJ65hEF3k,,cutting,109,111,2
VFyJ65hEF3k,,cutting,164,168,4
VFyJ65hEF3k,,tying,18,20,2
VFyJ65hEF3k,,tying,81,82,1
VFyJ65hEF3k,,tying,130,133,3
VFyJ65hEF3k,tying,tying,148,155,7
VFyJ65hEF3k,,tying,192,196,4
RCU-R4p16SU,,cutting,40,90,50
RCU-R4p16SU,,cutting,114,185,71
RCU-R4p16SU,,cutting,309,314,5
RCU-R4p16SU,,cutting,415,600,185
RCU-R4p16SU,,tying,227,245,18
RCU-R4p16SU,,tying,370,390,20
RCU-R4p16SU,,suturing,197,225,28
RCU-R4p16SU,,suturing,336,369,33
tE8Ml8aDk18,cutting,cutting,86,124,38
tE8Ml8aDk18,cutting,cutting,132,154,22
tE8Ml8aDk18,cutting,cutting,156,167,11
tE8Ml8aDk18,suturing,suturing,255,260,5
tE8Ml8aDk18,tying,suturing,261,266,5
tE8Ml8aDk18,suturing,suturing,267,284,17
tE8Ml8aDk18,tying,suturing,285,290,5
tE8Ml8aDk18,suturing,suturing,291,302,11
tE8Ml8aDk18,tying,suturing,303,314,11
tE8Ml8aDk18,suturing,suturing,315,320,5
tE8Ml8aDk18,tying,suturing,321,326,5
tE8Ml8aDk18,abstain,suturing,327,332,5
tE8Ml8aDk18,none,suturing,333,338,5
tE8Ml8aDk18,suturing,suturing,339,344,5
tE8Ml8aDk18,tying,suturing,345,350,5
tE8Ml8aDk18,abstain,suturing,351,356,5
tE8Ml8aDk18,suturing,suturing,357,362,5
tE8Ml8aDk18,tying,suturing,363,368,5
tE8Ml8aDk18,suturing,suturing,369,374,5
tE8Ml8aDk18,tying,suturing,375,380,5
tE8Ml8aDk18,abstain,suturing,381,386,5
tE8Ml8aDk18,suturing,suturing,387,398,11
tE8Ml8aDk18,tying,suturing,399,404,5
tE8Ml8aDk18,abstain,suturing,405,412,7
y0ie8xT6Hx0,cutting,cutting,34,39,5
y0ie8xT6Hx0,cutting,cutting,51,198,147
txCYSkZIrjE,,cutting,7,169,162
txCYSkZIrjE,,cutting,245,275,30
txCYSkZIrjE,,cutting,327,350,23
txCYSkZIrjE,,cutting,358,366,8
txCYSkZIrjE,,cutting,382,385,3
txCYSkZIrjE,,cutting,399,403,4
txCYSkZIrjE,,cutting,598,602,4
txCYSkZIrjE,,cutting,650,654,4
txCYSkZIrjE,,cutting,660,663,3
txCYSkZIrjE,,tying,299,308,9
txCYSkZIrjE,,tying,312,326,14
txCYSkZIrjE,,tying,671,684,13
txCYSkZIrjE,,tying,690,700,10
txCYSkZIrjE,,tying,725,730,5
txCYSkZIrjE,,suturing,709,723,14
7RljEDWk4ZU,cutting,cutting,101,106,5
7RljEDWk4ZU,cutting,cutting,123,132,9
7RljEDWk4ZU,cutting,cutting,142,150,8
7RljEDWk4ZU,cutting,cutting,163,184,21
7RljEDWk4ZU,tying,suturing,300,311,11
ejXLixqZVSs,cutting,cutting,247,320,73
ejXLixqZVSs,cutting,cutting,347,364,17
ejXLixqZVSs,cutting,cutting,405,434,29
ejXLixqZVSs,cutting,cutting,470,495,25
ejXLixqZVSs,,cutting,564,566,2
ejXLixqZVSs,cutting,cutting,584,594,10
ejXLixqZVSs,cutting,cutting,659,666,7
ejXLixqZVSs,cutting,cutting,693,710,17
ejXLixqZVSs,cutting,cutting,740,765,25
ejXLixqZVSs,,cutting,937,941,4
ejXLixqZVSs,cutting,cutting,1025,1049,24
ejXLixqZVSs,,cutting,1074,1076,2
ejXLixqZVSs,,cutting,1104,1106,2
ejXLixqZVSs,,cutting,1154,1156,2
ejXLixqZVSs,cutting,cutting,1284,1292,8
ejXLixqZVSs,,cutting,1414,1417,3
ejXLixqZVSs,,cutting,1464,1467,3
ejXLixqZVSs,,tying,846,851,5
ejXLixqZVSs,,tying,1158,1160,2
ejXLixqZVSs,tying,tying,1211,1250,39
ejXLixqZVSs,tying,tying,1264,1282,18
ejXLixqZVSs,tying,tying,1302,1318,16
ejXLixqZVSs,suturing,suturing,805,820,15
ejXLixqZVSs,,suturing,948,950,2
ejXLixqZVSs,suturing,suturing,1250,1255,5
ejXLixqZVSs,cutting,suturing,1256,1264,8
ejXLixqZVSs,suturing,suturing,1525,1571,46
En4tbEsYKwI,cutting,cutting,25,35,10
En4tbEsYKwI,cutting,cutting,60,90,30
En4tbEsYKwI,cutting,cutting,105,130,25
En4tbEsYKwI,cutting,cutting,140,150,10
tnXv-7fulTY,cutting,cutting,84,110,26
tnXv-7fulTY,cutting,cutting,128,153,25
sL5tVxz89i4,cutting,cutting,301,331,30
sL5tVxz89i4,cutting,cutting,342,408,66
sL5tVxz89i4,,cutting,440,445,5
sL5tVxz89i4,cutting,cutting,537,542,5
sL5tVxz89i4,cutting,cutting,858,964,106
sL5tVxz89i4,cutting,cutting,1056,1118,62
LgmXCOICHLA,,tying,143,147,4
LgmXCOICHLA,tying,tying,153,169,16
LgmXCOICHLA,tying,tying,173,184,11
LgmXCOICHLA,,tying,198,201,3
LgmXCOICHLA,tying,tying,207,213,6
LgmXCOICHLA,suturing,suturing,135,142,7
LgmXCOICHLA,,suturing,148,152,4
LgmXCOICHLA,,suturing,170,172,2
LgmXCOICHLA,suturing,suturing,191,197,6
LgmXCOICHLA,,suturing,202,206,4
LgmXCOICHLA,suturing,suturing,215,259,44
pWIti7kfTyk,,cutting,9,12,3
pWIti7kfTyk,suturing,tying,75,80,5
pWIti7kfTyk,tying,tying,81,97,16
vfHOapUt5kA,cutting,cutting,15,22,7
vfHOapUt5kA,cutting,cutting,22,33,11
vfHOapUt5kA,none,cutting,34,40,6
vfHOapUt5kA,cutting,cutting,45,56,11
vfHOapUt5kA,none,cutting,57,62,5
vfHOapUt5kA,cutting,cutting,63,85,22
vfHOapUt5kA,cutting,cutting,86,110,24
vfHOapUt5kA,tying,tying,235,242,7
vfHOapUt5kA,suturing,suturing,112,141,29
vfHOapUt5kA,cutting,suturing,142,147,5
vfHOapUt5kA,abstain,suturing,148,153,5
vfHOapUt5kA,suturing,suturing,154,171,17
vfHOapUt5kA,tying,suturing,172,183,11
vfHOapUt5kA,suturing,suturing,184,189,5
vfHOapUt5kA,tying,suturing,190,207,17
vfHOapUt5kA,suturing,suturing,208,219,11
vfHOapUt5kA,tying,suturing,220,225,5
vfHOapUt5kA,none,suturing,226,232,6
qxaOo9Q0g2M,cutting,cutting,47,60,13
qxaOo9Q0g2M,cutting,cutting,72,82,10
qxaOo9Q0g2M,cutting,cutting,84,96,12
qxaOo9Q0g2M,cutting,cutting,102,139,37
qxaOo9Q0g2M,cutting,cutting,158,164,6
qxaOo9Q0g2M,tying,tying,257,280,23
qxaOo9Q0g2M,suturing,tying,281,286,5
qxaOo9Q0g2M,tying,tying,287,297,10
qxaOo9Q0g2M,suturing,suturing,342,395,53
qxaOo9Q0g2M,tying,suturing,396,401,5
qxaOo9Q0g2M,abstain,suturing,402,407,5
qxaOo9Q0g2M,suturing,suturing,408,413,5
qxaOo9Q0g2M,tying,suturing,414,419,5
qxaOo9Q0g2M,suturing,suturing,420,465,45
Kvpfsw4yCrM,,cutting,229,233,4
Kvpfsw4yCrM,,tying,203,217,14
Kvpfsw4yCrM,,tying,250,260,10
YGJLGKetzy0,none,cutting,35,161,126
2ekkzoZ_uns,,cutting,10,26,16
2ekkzoZ_uns,,cutting,49,53,4
2ekkzoZ_uns,,tying,525,527,2
2ekkzoZ_uns,,tying,589,593,4
2ekkzoZ_uns,,tying,596,599,3
2ekkzoZ_uns,,suturing,501,504,3
2ekkzoZ_uns,,suturing,514,521,7
2ekkzoZ_uns,,suturing,564,568,4
2ekkzoZ_uns,,suturing,572,578,6
2ekkzoZ_uns,,suturing,579,586,7
wIr-9Myre4k,cutting,cutting,67,99,32
wIr-9Myre4k,cutting,cutting,109,138,29
wIr-9Myre4k,cutting,cutting,169,183,14
wIr-9Myre4k,cutting,cutting,270,328,58
wIr-9Myre4k,cutting,cutting,340,358,18
wIr-9Myre4k,tying,tying,227,234,7
wIr-9Myre4k,,tying,415,418,3
wIr-9Myre4k,suturing,suturing,100,108,8
wIr-9Myre4k,suturing,suturing,184,219,35
wIr-9Myre4k,suturing,suturing,374,407,33
wmDkmO4PAYI,cutting,cutting,67,83,16
wmDkmO4PAYI,cutting,cutting,106,121,15
wmDkmO4PAYI,,tying,703,715,12
wmDkmO4PAYI,,suturing,629,630,1
wmDkmO4PAYI,,suturing,674,678,4
Sz57XML7IGA,cutting,cutting,66,84,18
ZXQPWRUdFqc,cutting,cutting,72,118,46
ZXQPWRUdFqc,cutting,cutting,131,138,7
ZXQPWRUdFqc,,cutting,205,208,3
ZXQPWRUdFqc,,tying,175,180,5
ZXQPWRUdFqc,tying,tying,187,203,16
ZXQPWRUdFqc,suturing,suturing,153,175,22
GQQzVPySxPI,cutting,cutting,77,140,63
GQQzVPySxPI,cutting,cutting,149,176,27
GQQzVPySxPI,cutting,cutting,182,230,48
GQQzVPySxPI,cutting,cutting,324,332,8
GQQzVPySxPI,cutting,cutting,427,442,15
GQQzVPySxPI,,tying,263,268,5
GQQzVPySxPI,suturing,tying,301,310,9
GQQzVPySxPI,tying,tying,374,381,7
GQQzVPySxPI,,tying,411,415,4
GQQzVPySxPI,suturing,suturing,237,263,26
GQQzVPySxPI,suturing,suturing,293,301,8
GQQzVPySxPI,suturing,suturing,314,323,9
GQQzVPySxPI,suturing,suturing,333,344,11
GQQzVPySxPI,tying,suturing,345,350,5
GQQzVPySxPI,suturing,suturing,351,368,17
GQQzVPySxPI,suturing,suturing,382,405,23
PzaCNn8IIVw,cutting,cutting,21,95,74
PzaCNn8IIVw,suturing,suturing,103,120,17
SRQb7RGQ52M,cutting,cutting,16,72,56
SRQb7RGQ52M,cutting,cutting,239,246,7
8OK-_4Wx3QY,cutting,cutting,34,60,26
8OK-_4Wx3QY,cutting,cutting,73,89,16
8OK-_4Wx3QY,,cutting,95,97,2
8OK-_4Wx3QY,,cutting,119,121,2
8OK-_4Wx3QY,,cutting,157,160,3
8OK-_4Wx3QY,,cutting,420,423,3
8OK-_4Wx3QY,,cutting,433,435,2
8OK-_4Wx3QY,cutting,cutting,535,545,10
8OK-_4Wx3QY,,cutting,547,550,3
8OK-_4Wx3QY,,cutting,1087,1090,3
8OK-_4Wx3QY,tying,tying,298,317,19
8OK-_4Wx3QY,tying,tying,340,350,10
8OK-_4Wx3QY,tying,tying,457,496,39
8OK-_4Wx3QY,,tying,508,512,4
8OK-_4Wx3QY,tying,tying,520,528,8
8OK-_4Wx3QY,tying,tying,665,684,19
8OK-_4Wx3QY,tying,tying,731,750,19
8OK-_4Wx3QY,tying,tying,781,791,10
8OK-_4Wx3QY,suturing,tying,808,815,7
8OK-_4Wx3QY,tying,tying,827,836,9
8OK-_4Wx3QY,tying,tying,849,859,10
8OK-_4Wx3QY,tying,tying,876,892,16
8OK-_4Wx3QY,tying,tying,902,915,13
8OK-_4Wx3QY,tying,tying,988,1004,16
8OK-_4Wx3QY,,tying,1010,1014,4
8OK-_4Wx3QY,tying,tying,1046,1059,13
8OK-_4Wx3QY,tying,tying,1076,1083,7
8OK-_4Wx3QY,,tying,1100,1104,4
8OK-_4Wx3QY,tying,tying,1120,1126,6
8OK-_4Wx3QY,tying,tying,1150,1159,9
8OK-_4Wx3QY,tying,tying,1172,1177,5
8OK-_4Wx3QY,tying,tying,1194,1201,7
8OK-_4Wx3QY,tying,tying,1215,1225,10
8OK-_4Wx3QY,,suturing,660,665,5
8OK-_4Wx3QY,suturing,suturing,691,730,39
8OK-_4Wx3QY,suturing,suturing,769,774,5
8OK-_4Wx3QY,suturing,suturing,799,807,8
8OK-_4Wx3QY,suturing,suturing,820,826,6
8OK-_4Wx3QY,suturing,suturing,842,848,6
8OK-_4Wx3QY,suturing,suturing,868,875,7
8OK-_4Wx3QY,suturing,suturing,895,901,6
8OK-_4Wx3QY,,suturing,984,987,3
8OK-_4Wx3QY,,suturing,1005,1009,4
8OK-_4Wx3QY,suturing,suturing,1015,1045,30
8OK-_4Wx3QY,suturing,suturing,1068,1075,7
8OK-_4Wx3QY,suturing,suturing,1093,1099,6
8OK-_4Wx3QY,suturing,suturing,1109,1119,10
8OK-_4Wx3QY,suturing,suturing,1142,1149,7
8OK-_4Wx3QY,,suturing,1166,1171,5
8OK-_4Wx3QY,,suturing,1189,1193,4
8OK-_4Wx3QY,,suturing,1211,1214,3
8OK-_4Wx3QY,,suturing,1232,1236,4
wIVcst7zrig,,cutting,112,118,6
wIVcst7zrig,,cutting,189,198,9
wIVcst7zrig,,cutting,221,240,19
wIVcst7zrig,,suturing,275,280,5
wIVcst7zrig,,suturing,308,311,3
wIVcst7zrig,,suturing,390,393,3
e12tIDPDfwU,,cutting,11,16,5
e12tIDPDfwU,cutting,cutting,21,26,5
e12tIDPDfwU,cutting,cutting,37,44,7
e12tIDPDfwU,tying,tying,94,103,9
e12tIDPDfwU,tying,tying,168,183,15
e12tIDPDfwU,suturing,suturing,75,84,9
e12tIDPDfwU,,suturing,117,120,3
e12tIDPDfwU,suturing,suturing,124,133,9
e12tIDPDfwU,,suturing,141,144,3
e12tIDPDfwU,suturing,suturing,152,164,12
e12tIDPDfwU,,suturing,196,201,5
e12tIDPDfwU,,suturing,219,221,2
e12tIDPDfwU,,suturing,232,236,4
e12tIDPDfwU,suturing,suturing,258,280,22
sWxGr_rj7rM,cutting,cutting,97,128,31
sWxGr_rj7rM,cutting,cutting,137,176,39
sWxGr_rj7rM,,cutting,255,260,5
sWxGr_rj7rM,cutting,cutting,265,289,24
sWxGr_rj7rM,tying,tying,346,352,6
sWxGr_rj7rM,suturing,suturing,50,59,9
sWxGr_rj7rM,suturing,suturing,369,379,10
sWxGr_rj7rM,suturing,suturing,397,404,7
sWxGr_rj7rM,suturing,suturing,411,446,35
sWxGr_rj7rM,suturing,suturing,462,489,27
sWxGr_rj7rM,suturing,suturing,538,547,9
A42Nt7WsxTE,none,cutting,180,185,5
A42Nt7WsxTE,,cutting,213,273,60
A42Nt7WsxTE,,cutting,279,290,11
A42Nt7WsxTE,,cutting,306,310,4
A42Nt7WsxTE,,cutting,455,461,6
A42Nt7WsxTE,,cutting,485,498,13
A42Nt7WsxTE,,suturing,560,595,35
JUTyS7ZRRkQ,suturing,suturing,50,55,5
JUTyS7ZRRkQ,tying,suturing,56,69,13
JUTyS7ZRRkQ,suturing,suturing,90,113,23
JUTyS7ZRRkQ,suturing,suturing,195,207,12
JUTyS7ZRRkQ,suturing,suturing,236,247,11
JUTyS7ZRRkQ,tying,suturing,248,255,7
JUTyS7ZRRkQ,suturing,suturing,262,275,13
JUTyS7ZRRkQ,suturing,suturing,351,358,7
JUTyS7ZRRkQ,,suturing,417,421,4
JUTyS7ZRRkQ,,suturing,439,444,5
JUTyS7ZRRkQ,suturing,suturing,475,515,40
JUTyS7ZRRkQ,suturing,suturing,530,552,22
UDaMvSGMa3w,cutting,cutting,0,22,22
UDaMvSGMa3w,cutting,cutting,108,118,10
PyIDO9qA2_g,cutting,cutting,46,93,47
PyIDO9qA2_g,none,cutting,94,99,5
PyIDO9qA2_g,cutting,cutting,100,141,41
PyIDO9qA2_g,none,cutting,142,147,5
PyIDO9qA2_g,cutting,cutting,148,190,42
daht-zR1G4s,,cutting,66,68,2
daht-zR1G4s,,cutting,71,78,7
daht-zR1G4s,,cutting,115,118,3
daht-zR1G4s,,cutting,121,126,5
daht-zR1G4s,,cutting,127,136,9
daht-zR1G4s,,cutting,138,156,18
daht-zR1G4s,,cutting,170,180,10
daht-zR1G4s,,cutting,206,208,2
daht-zR1G4s,,tying,235,242,7
daht-zR1G4s,,tying,248,252,4
daht-zR1G4s,,tying,293,304,11
daht-zR1G4s,,tying,312,318,6
daht-zR1G4s,,tying,360,365,5
daht-zR1G4s,,suturing,229,233,4
daht-zR1G4s,,suturing,284,291,7
daht-zR1G4s,,suturing,306,311,5
daht-zR1G4s,,suturing,349,356,7
kRWNgDQ-WcU,cutting,cutting,0,5,5
kRWNgDQ-WcU,none,cutting,6,11,5
kRWNgDQ-WcU,cutting,cutting,12,62,50
kRWNgDQ-WcU,cutting,cutting,68,87,19
kRWNgDQ-WcU,cutting,cutting,177,184,7
kRWNgDQ-WcU,,cutting,235,239,4
kRWNgDQ-WcU,,cutting,242,245,3
kRWNgDQ-WcU,cutting,cutting,340,345,5
kRWNgDQ-WcU,,cutting,359,361,2
kRWNgDQ-WcU,tying,tying,147,158,11
kRWNgDQ-WcU,tying,tying,212,226,14
kRWNgDQ-WcU,tying,tying,314,340,26
kRWNgDQ-WcU,tying,tying,384,393,9
kRWNgDQ-WcU,tying,tying,485,494,9
kRWNgDQ-WcU,tying,tying,557,573,16
kRWNgDQ-WcU,,tying,623,628,5
kRWNgDQ-WcU,tying,tying,634,652,18
kRWNgDQ-WcU,tying,tying,676,686,10
kRWNgDQ-WcU,tying,tying,697,705,8
kRWNgDQ-WcU,tying,tying,714,720,6
kRWNgDQ-WcU,,suturing,138,142,4
kRWNgDQ-WcU,cutting,suturing,200,209,9
kRWNgDQ-WcU,suturing,suturing,368,381,13
kRWNgDQ-WcU,suturing,suturing,415,438,23
kRWNgDQ-WcU,none,suturing,439,444,5
kRWNgDQ-WcU,suturing,suturing,445,484,39
kRWNgDQ-WcU,suturing,suturing,550,556,6
kRWNgDQ-WcU,suturing,suturing,581,616,35
kRWNgDQ-WcU,,suturing,629,633,4
kRWNgDQ-WcU,,suturing,670,675,5
kRWNgDQ-WcU,,suturing,691,696,5
kRWNgDQ-WcU,,suturing,710,713,3
kRWNgDQ-WcU,suturing,suturing,726,828,102
qaAoYqg2vWo,cutting,cutting,4,153,149
qaAoYqg2vWo,none,cutting,154,159,5
qaAoYqg2vWo,cutting,cutting,160,189,29
qaAoYqg2vWo,tying,tying,476,494,18
qaAoYqg2vWo,tying,tying,499,519,20
qaAoYqg2vWo,tying,tying,539,557,18
qaAoYqg2vWo,tying,tying,787,808,21
qaAoYqg2vWo,suturing,tying,816,821,5
qaAoYqg2vWo,tying,tying,822,833,11
qaAoYqg2vWo,suturing,tying,834,845,11
qaAoYqg2vWo,tying,tying,846,870,24
FotC4hB7Y0c,,cutting,3,17,14
FotC4hB7Y0c,,cutting,18,34,16
FotC4hB7Y0c,,cutting,128,144,16
FotC4hB7Y0c,,tying,102,114,12
FotC4hB7Y0c,,tying,166,180,14
FotC4hB7Y0c,,tying,210,217,7
FotC4hB7Y0c,,suturing,99,102,3
FotC4hB7Y0c,,suturing,146,164,18
FotC4hB7Y0c,,suturing,183,200,17
iUwBjZUs_xo,cutting,cutting,18,101,83
iUwBjZUs_xo,cutting,cutting,108,143,35
iUwBjZUs_xo,none,cutting,144,149,5
iUwBjZUs_xo,cutting,cutting,150,161,11
iUwBjZUs_xo,none,cutting,162,167,5
iUwBjZUs_xo,cutting,cutting,168,191,23
iUwBjZUs_xo,none,cutting,192,197,5
iUwBjZUs_xo,cutting,cutting,198,203,5
iUwBjZUs_xo,none,cutting,204,215,11
iUwBjZUs_xo,cutting,cutting,216,281,65
iUwBjZUs_xo,none,cutting,282,293,11
iUwBjZUs_xo,cutting,cutting,294,335,41
iUwBjZUs_xo,tying,cutting,336,341,5
iUwBjZUs_xo,cutting,cutting,342,387,45
TZ9IgsIMRW4,cutting,cutting,124,135,11
TZ9IgsIMRW4,none,cutting,136,141,5
TZ9IgsIMRW4,cutting,cutting,142,150,8
TZ9IgsIMRW4,cutting,cutting,234,296,62
TZ9IgsIMRW4,tying,tying,183,214,31
TZ9IgsIMRW4,suturing,suturing,170,182,12
DM3aDFlbh9A,cutting,cutting,312,347,35
DM3aDFlbh9A,none,cutting,348,353,5
DM3aDFlbh9A,none,cutting,360,401,41
DM3aDFlbh9A,cutting,cutting,402,508,106
DM3aDFlbh9A,cutting,cutting,716,733,17
DM3aDFlbh9A,none,cutting,734,743,9
DM3aDFlbh9A,suturing,tying,810,821,11
DM3aDFlbh9A,tying,tying,822,884,62
DM3aDFlbh9A,tying,tying,993,1004,11
DM3aDFlbh9A,suturing,suturing,567,578,11
DM3aDFlbh9A,tying,suturing,579,590,11
DM3aDFlbh9A,suturing,suturing,591,596,5
DM3aDFlbh9A,tying,suturing,597,644,47
GkKGPN4gado,cutting,cutting,7,124,117
GkKGPN4gado,cutting,cutting,240,258,18
GkKGPN4gado,tying,tying,146,166,20
GkKGPN4gado,suturing,suturing,134,139,5
GkKGPN4gado,suturing,suturing,167,196,29
GkKGPN4gado,none,suturing,197,208,11
GkKGPN4gado,suturing,suturing,209,235,26
2j-J2IiHLB8,cutting,cutting,401,406,5
2j-J2IiHLB8,cutting,cutting,403,408,5
2j-J2IiHLB8,cutting,cutting,407,413,6
2j-J2IiHLB8,,cutting,415,435,20
2j-J2IiHLB8,cutting,cutting,465,470,5
2j-J2IiHLB8,cutting,cutting,469,474,5
2j-J2IiHLB8,cutting,cutting,471,476,5
2j-J2IiHLB8,cutting,cutting,475,480,5
2j-J2IiHLB8,cutting,cutting,477,482,5
2j-J2IiHLB8,cutting,cutting,481,486,5
2j-J2IiHLB8,cutting,cutting,483,488,5
2j-J2IiHLB8,cutting,cutting,487,492,5
2j-J2IiHLB8,cutting,cutting,489,494,5
2j-J2IiHLB8,cutting,cutting,506,511,5
2j-J2IiHLB8,cutting,cutting,511,516,5
2j-J2IiHLB8,cutting,cutting,512,517,5
2j-J2IiHLB8,cutting,cutting,517,522,5
2j-J2IiHLB8,cutting,cutting,518,523,5
2j-J2IiHLB8,cutting,cutting,523,528,5
2j-J2IiHLB8,cutting,cutting,524,532,8
2j-J2IiHLB8,,cutting,541,550,9
2j-J2IiHLB8,cutting,cutting,590,595,5
2j-J2IiHLB8,cutting,cutting,595,600,5
2j-J2IiHLB8,cutting,cutting,596,601,5
2j-J2IiHLB8,cutting,cutting,601,606,5
2j-J2IiHLB8,cutting,cutting,602,607,5
2j-J2IiHLB8,cutting,cutting,607,612,5
2j-J2IiHLB8,cutting,cutting,608,613,5
2j-J2IiHLB8,cutting,cutting,613,618,5
2j-J2IiHLB8,cutting,cutting,614,619,5
2j-J2IiHLB8,cutting,cutting,619,624,5
2j-J2IiHLB8,cutting,cutting,620,625,5
2j-J2IiHLB8,cutting,cutting,625,630,5
2j-J2IiHLB8,cutting,cutting,626,635,9
2j-J2IiHLB8,cutting,cutting,638,643,5
2j-J2IiHLB8,cutting,cutting,643,648,5
2j-J2IiHLB8,cutting,cutting,644,652,8
2j-J2IiHLB8,,cutting,678,682,4
2j-J2IiHLB8,cutting,cutting,682,692,10
2j-J2IiHLB8,cutting,cutting,717,722,5
2j-J2IiHLB8,cutting,cutting,721,726,5
2j-J2IiHLB8,cutting,cutting,723,728,5
2j-J2IiHLB8,cutting,cutting,737,742,5
2j-J2IiHLB8,cutting,cutting,739,744,5
2j-J2IiHLB8,cutting,cutting,743,748,5
2j-J2IiHLB8,cutting,cutting,745,750,5
2j-J2IiHLB8,cutting,cutting,749,757,8
2j-J2IiHLB8,none,cutting,49,402,353
2j-J2IiHLB8,cutting,cutting,401,406,5
2j-J2IiHLB8,cutting,cutting,403,408,5
2j-J2IiHLB8,cutting,cutting,407,412,5
2j-J2IiHLB8,cutting,cutting,409,438,29
2j-J2IiHLB8,none,cutting,439,450,11
2j-J2IiHLB8,cutting,cutting,451,468,17
2j-J2IiHLB8,cutting,cutting,465,470,5
2j-J2IiHLB8,cutting,cutting,469,474,5
2j-J2IiHLB8,cutting,cutting,471,476,5
2j-J2IiHLB8,cutting,cutting,475,480,5
2j-J2IiHLB8,cutting,cutting,477,482,5
2j-J2IiHLB8,cutting,cutting,481,486,5
2j-J2IiHLB8,cutting,cutting,483,488,5
2j-J2IiHLB8,cutting,cutting,487,492,5
2j-J2IiHLB8,cutting,cutting,489,494,5
2j-J2IiHLB8,cutting,cutting,493,510,17
2j-J2IiHLB8,cutting,cutting,506,511,5
2j-J2IiHLB8,cutting,cutting,511,516,5
2j-J2IiHLB8,cutting,cutting,512,517,5
2j-J2IiHLB8,cutting,cutting,517,522,5
2j-J2IiHLB8,cutting,cutting,518,523,5
2j-J2IiHLB8,cutting,cutting,523,528,5
2j-J2IiHLB8,cutting,cutting,524,529,5
2j-J2IiHLB8,cutting,cutting,529,570,41
2j-J2IiHLB8,none,cutting,571,576,5
2j-J2IiHLB8,cutting,cutting,577,594,17
2j-J2IiHLB8,cutting,cutting,590,595,5
2j-J2IiHLB8,cutting,cutting,595,600,5
2j-J2IiHLB8,cutting,cutting,596,601,5
2j-J2IiHLB8,cutting,cutting,601,606,5
2j-J2IiHLB8,cutting,cutting,602,607,5
2j-J2IiHLB8,cutting,cutting,607,612,5
2j-J2IiHLB8,cutting,cutting,608,613,5
2j-J2IiHLB8,cutting,cutting,613,618,5
2j-J2IiHLB8,cutting,cutting,614,619,5
2j-J2IiHLB8,cutting,cutting,619,624,5
2j-J2IiHLB8,cutting,cutting,620,625,5
2j-J2IiHLB8,cutting,cutting,625,630,5
2j-J2IiHLB8,cutting,cutting,626,631,5
2j-J2IiHLB8,cutting,cutting,631,642,11
2j-J2IiHLB8,cutting,cutting,638,643,5
2j-J2IiHLB8,cutting,cutting,643,648,5
2j-J2IiHLB8,cutting,cutting,644,649,5
2j-J2IiHLB8,cutting,cutting,649,684,35
2j-J2IiHLB8,cutting,cutting,682,687,5
2j-J2IiHLB8,cutting,cutting,685,696,11
2j-J2IiHLB8,none,cutting,697,702,5
2j-J2IiHLB8,cutting,cutting,703,720,17
2j-J2IiHLB8,cutting,cutting,717,722,5
2j-J2IiHLB8,cutting,cutting,721,726,5
2j-J2IiHLB8,cutting,cutting,723,728,5
2j-J2IiHLB8,cutting,cutting,727,738,11
2j-J2IiHLB8,cutting,cutting,737,742,5
2j-J2IiHLB8,cutting,cutting,739,744,5
2j-J2IiHLB8,cutting,cutting,743,748,5
2j-J2IiHLB8,cutting,cutting,745,750,5
2j-J2IiHLB8,cutting,cutting,749,754,5
2j-J2IiHLB8,cutting,cutting,751,768,17
2j-J2IiHLB8,,cutting,810,813,3
2j-J2IiHLB8,,cutting,815,820,5
2j-J2IiHLB8,cutting,cutting,839,847,8
2j-J2IiHLB8,,cutting,849,853,4
2j-J2IiHLB8,cutting,cutting,862,877,15
2j-J2IiHLB8,cutting,cutting,879,891,12
2j-J2IiHLB8,cutting,cutting,901,914,13
2j-J2IiHLB8,cutting,cutting,917,926,9
2j-J2IiHLB8,,cutting,933,936,3
2j-J2IiHLB8,cutting,cutting,947,991,44
2j-J2IiHLB8,cutting,cutting,1251,1259,8
2j-J2IiHLB8,tying,tying,1284,1295,11
2j-J2IiHLB8,tying,tying,1332,1341,9
2j-J2IiHLB8,tying,tying,1212,1222,10
2j-J2IiHLB8,suturing,suturing,1132,1139,7
2j-J2IiHLB8,suturing,suturing,1142,1157,15
2j-J2IiHLB8,suturing,suturing,1184,1194,10
2j-J2IiHLB8,,suturing,1201,1206,5
2j-J2IiHLB8,,suturing,1236,1238,2
2j-J2IiHLB8,,suturing,1263,1265,2
2j-J2IiHLB8,suturing,suturing,1271,1279,8
2j-J2IiHLB8,,suturing,1313,1318,5
2j-J2IiHLB8,,suturing,1324,1329,5
tbxSEoWwqCM,cutting,cutting,2,16,14
tbxSEoWwqCM,cutting,cutting,59,87,28
3Fx1EiO5iRY,,cutting,93,113,20
3Fx1EiO5iRY,,cutting,123,183,60
3Fx1EiO5iRY,,cutting,270,280,10
3Fx1EiO5iRY,,cutting,303,307,4
3Fx1EiO5iRY,,tying,22,28,6
3Fx1EiO5iRY,,tying,374,380,6
3Fx1EiO5iRY,,tying,470,476,6
3Fx1EiO5iRY,,tying,645,650,5
3Fx1EiO5iRY,,suturing,33,80,47
3Fx1EiO5iRY,,suturing,360,374,14
VvTrKCFtZhA,,cutting,50,80,30
VvTrKCFtZhA,,cutting,199,300,101
VvTrKCFtZhA,,tying,460,550,90
VvTrKCFtZhA,,tying,580,600,20
VvTrKCFtZhA,,suturing,380,460,80
VvTrKCFtZhA,,suturing,550,580,30
bxm902jT1Ok,abstain,cutting,97,183,86
4uwsmL5TwGI,cutting,cutting,5,60,55
4uwsmL5TwGI,,tying,182,186,4
4uwsmL5TwGI,,suturing,149,154,5
4uwsmL5TwGI,,suturing,159,166,7
4uwsmL5TwGI,,suturing,179,181,2
zOHKqmSAZto,cutting,cutting,100,118,18
zOHKqmSAZto,cutting,cutting,138,145,7
zOHKqmSAZto,,cutting,158,159,1
zOHKqmSAZto,,cutting,169,171,2
zOHKqmSAZto,,cutting,178,182,4
zOHKqmSAZto,,cutting,196,199,3
zOHKqmSAZto,,cutting,213,214,1
zOHKqmSAZto,cutting,cutting,219,227,8
zOHKqmSAZto,cutting,cutting,378,420,42
zOHKqmSAZto,tying,tying,460,469,9
zOHKqmSAZto,tying,tying,484,492,8
zOHKqmSAZto,tying,tying,496,505,9
zOHKqmSAZto,suturing,suturing,437,455,18
zOHKqmSAZto,suturing,suturing,473,483,10
sFZchKZ10bc,,cutting,48,50,2
sFZchKZ10bc,,cutting,55,56,1
sFZchKZ10bc,cutting,cutting,58,103,45
sFZchKZ10bc,cutting,cutting,108,122,14
sFZchKZ10bc,,cutting,134,138,4
sFZchKZ10bc,,cutting,151,154,3
sFZchKZ10bc,,cutting,159,162,3
sFZchKZ10bc,,cutting,167,170,3
sFZchKZ10bc,cutting,cutting,171,187,16
sFZchKZ10bc,,tying,224,225,1
sFZchKZ10bc,,tying,254,256,2
sFZchKZ10bc,,tying,274,279,5
sFZchKZ10bc,,tying,337,340,3
sFZchKZ10bc,,suturing,220,223,3
sFZchKZ10bc,suturing,suturing,237,250,13
sFZchKZ10bc,suturing,suturing,257,263,6
sFZchKZ10bc,,suturing,267,269,2
sFZchKZ10bc,,suturing,294,297,3
sFZchKZ10bc,,suturing,298,301,3
sFZchKZ10bc,,suturing,313,316,3
sFZchKZ10bc,,suturing,317,319,2
sFZchKZ10bc,,suturing,320,323,3
sFZchKZ10bc,,suturing,326,331,5
PsYnEXGxf-M,none,cutting,222,229,7
PsYnEXGxf-M,,cutting,235,239,4
PsYnEXGxf-M,none,cutting,241,248,7
PsYnEXGxf-M,cutting,cutting,255,264,9
PsYnEXGxf-M,cutting,cutting,277,336,59
PsYnEXGxf-M,cutting,cutting,390,475,85
PsYnEXGxf-M,cutting,cutting,479,544,65
PsYnEXGxf-M,cutting,cutting,561,602,41
PsYnEXGxf-M,cutting,cutting,687,698,11
PsYnEXGxf-M,none,cutting,699,707,8
PsYnEXGxf-M,none,cutting,714,719,5
PsYnEXGxf-M,cutting,cutting,720,737,17
PsYnEXGxf-M,none,cutting,738,750,12
PsYnEXGxf-M,none,cutting,768,773,5
PsYnEXGxf-M,cutting,cutting,774,779,5
PsYnEXGxf-M,none,cutting,780,797,17
PsYnEXGxf-M,cutting,cutting,798,809,11
ZAwOzpqlZkA,cutting,cutting,53,71,18
ZAwOzpqlZkA,cutting,cutting,78,88,10
ZAwOzpqlZkA,cutting,cutting,96,106,10
ZAwOzpqlZkA,tying,tying,127,154,27
ZAwOzpqlZkA,tying,tying,166,177,11
ZAwOzpqlZkA,,tying,197,202,5
ZAwOzpqlZkA,tying,tying,220,237,17
ZAwOzpqlZkA,suturing,suturing,119,126,7
ZAwOzpqlZkA,,suturing,160,164,4
ZAwOzpqlZkA,suturing,suturing,185,190,5
ZAwOzpqlZkA,suturing,suturing,202,218,16
sWfWnFk1W70,,cutting,154,157,3
USL06hfnyKg,cutting,cutting,20,33,13
USL06hfnyKg,,cutting,37,40,3
USL06hfnyKg,cutting,cutting,47,55,8
USL06hfnyKg,,cutting,75,80,5
USL06hfnyKg,suturing,suturing,105,125,20
ATEuI_Y69CI,cutting,cutting,189,204,15
ATEuI_Y69CI,,cutting,237,242,5
ATEuI_Y69CI,,cutting,257,259,2
tOLu-p5V-7o,cutting,cutting,3,36,33
tOLu-p5V-7o,,tying,144,148,4
tOLu-p5V-7o,,tying,156,160,4
tOLu-p5V-7o,suturing,suturing,132,142,10
tOLu-p5V-7o,,suturing,398,414,16
7YXOJzIrKFM,none,cutting,22,141,119
7YXOJzIrKFM,cutting,cutting,142,153,11
7YXOJzIrKFM,none,cutting,154,171,17
7YXOJzIrKFM,cutting,cutting,172,177,5
HSXoe4PkkWI,cutting,cutting,97,127,30
HSXoe4PkkWI,cutting,cutting,157,188,31
HSXoe4PkkWI,cutting,cutting,194,220,26
HSXoe4PkkWI,cutting,cutting,227,276,49
HSXoe4PkkWI,cutting,cutting,303,316,13
HSXoe4PkkWI,cutting,cutting,338,380,42
HSXoe4PkkWI,,cutting,422,425,3
HSXoe4PkkWI,cutting,cutting,470,488,18
HSXoe4PkkWI,cutting,cutting,545,578,33
HSXoe4PkkWI,cutting,cutting,611,624,13
HSXoe4PkkWI,cutting,cutting,726,758,32
HSXoe4PkkWI,cutting,cutting,783,794,11
HSXoe4PkkWI,cutting,cutting,809,818,9
HSXoe4PkkWI,cutting,cutting,949,968,19
HSXoe4PkkWI,cutting,cutting,976,989,13
HSXoe4PkkWI,cutting,cutting,1073,1083,10
HSXoe4PkkWI,cutting,cutting,1412,1446,34
HSXoe4PkkWI,tying,tying,20,82,62
HSXoe4PkkWI,tying,tying,277,302,25
HSXoe4PkkWI,,tying,416,421,5
HSXoe4PkkWI,tying,tying,431,459,28
HSXoe4PkkWI,tying,tying,489,501,12
HSXoe4PkkWI,,tying,525,529,4
HSXoe4PkkWI,tying,tying,652,684,32
HSXoe4PkkWI,tying,tying,859,869,10
HSXoe4PkkWI,tying,tying,1044,1051,7
HSXoe4PkkWI,tying,tying,1053,1073,20
HSXoe4PkkWI,,tying,1112,1116,4
HSXoe4PkkWI,,tying,1131,1136,5
HSXoe4PkkWI,tying,tying,1180,1200,20
HSXoe4PkkWI,tying,tying,1333,1349,16
HSXoe4PkkWI,tying,tying,1354,1379,25
HSXoe4PkkWI,tying,tying,1396,1410,14
HSXoe4PkkWI,tying,tying,1452,1458,6
HSXoe4PkkWI,tying,tying,1479,1491,12
HSXoe4PkkWI,tying,tying,1501,1517,16
HSXoe4PkkWI,suturing,suturing,317,324,7
HSXoe4PkkWI,,suturing,425,430,5
HSXoe4PkkWI,,suturing,519,524,5
HSXoe4PkkWI,suturing,suturing,631,651,20
HSXoe4PkkWI,suturing,suturing,819,858,39
HSXoe4PkkWI,suturing,suturing,893,906,13
HSXoe4PkkWI,suturing,suturing,916,947,31
HSXoe4PkkWI,suturing,suturing,1011,1034,23
HSXoe4PkkWI,tying,suturing,1035,1041,6
HSXoe4PkkWI,suturing,suturing,1103,1111,8
HSXoe4PkkWI,suturing,suturing,1117,1130,13
HSXoe4PkkWI,suturing,suturing,1137,1166,29
HSXoe4PkkWI,tying,suturing,1167,1172,5
HSXoe4PkkWI,suturing,suturing,1173,1179,6
HSXoe4PkkWI,suturing,suturing,1217,1270,53
HSXoe4PkkWI,suturing,suturing,1295,1318,23
HSXoe4PkkWI,suturing,suturing,1389,1395,6
HSXoe4PkkWI,,suturing,1448,1451,3
HSXoe4PkkWI,suturing,suturing,1459,1478,19
HSXoe4PkkWI,suturing,suturing,1492,1500,8
HSXoe4PkkWI,suturing,suturing,1518,1573,55
zJkQP-BFl8c,cutting,cutting,33,39,6
zJkQP-BFl8c,,cutting,75,80,5
zJkQP-BFl8c,cutting,cutting,93,99,6
zJkQP-BFl8c,,cutting,106,111,5
Yl3S1UtzmFI,,cutting,8,10,2
Yl3S1UtzmFI,cutting,cutting,11,38,27
Yl3S1UtzmFI,cutting,cutting,41,52,11
Yl3S1UtzmFI,,tying,91,94,3
Yl3S1UtzmFI,tying,tying,108,118,10
Yl3S1UtzmFI,,tying,136,138,2
Yl3S1UtzmFI,tying,tying,152,161,9
Yl3S1UtzmFI,,tying,179,182,3
Yl3S1UtzmFI,,tying,186,188,2
Yl3S1UtzmFI,tying,tying,193,198,5
Yl3S1UtzmFI,tying,tying,244,249,5
Yl3S1UtzmFI,tying,tying,276,286,10
Yl3S1UtzmFI,suturing,suturing,82,90,8
Yl3S1UtzmFI,,suturing,96,98,2
Yl3S1UtzmFI,suturing,suturing,100,106,6
Yl3S1UtzmFI,suturing,suturing,121,130,9
Yl3S1UtzmFI,suturing,suturing,142,150,8
Yl3S1UtzmFI,,suturing,166,170,4
Yl3S1UtzmFI,,suturing,174,177,3
Yl3S1UtzmFI,,suturing,192,193,1
Yl3S1UtzmFI,suturing,suturing,212,224,12
Yl3S1UtzmFI,,suturing,234,238,4
Yl3S1UtzmFI,,suturing,262,265,3
GwHruH8trhg,,cutting,0,4,4
GwHruH8trhg,,tying,99,104,5
GwHruH8trhg,tying,tying,209,220,11
GwHruH8trhg,tying,tying,315,330,15
GwHruH8trhg,,suturing,92,94,2
GwHruH8trhg,suturing,suturing,111,125,14
GwHruH8trhg,suturing,suturing,185,202,17
GwHruH8trhg,suturing,suturing,240,268,28
GwHruH8trhg,suturing,suturing,273,283,10
GwHruH8trhg,suturing,suturing,285,312,27
wDu9VyqfNu8,,cutting,77,80,3
wDu9VyqfNu8,tying,tying,332,349,17
wDu9VyqfNu8,tying,tying,436,451,15
wDu9VyqfNu8,tying,tying,487,514,27
wDu9VyqfNu8,cutting,tying,524,530,6
wDu9VyqfNu8,tying,tying,587,601,14
wDu9VyqfNu8,tying,tying,655,661,6
wDu9VyqfNu8,tying,tying,721,734,13
wDu9VyqfNu8,tying,tying,763,773,10
wDu9VyqfNu8,tying,tying,833,841,8
wDu9VyqfNu8,tying,tying,866,874,8
wDu9VyqfNu8,tying,tying,894,900,6
wDu9VyqfNu8,suturing,suturing,613,653,40
wDu9VyqfNu8,suturing,suturing,689,694,5
wDu9VyqfNu8,cutting,suturing,695,712,17
wDu9VyqfNu8,,suturing,759,762,3
wDu9VyqfNu8,suturing,suturing,779,785,6
wDu9VyqfNu8,suturing,suturing,803,826,23
wDu9VyqfNu8,suturing,suturing,855,865,10
wDu9VyqfNu8,suturing,suturing,880,893,13
eYrOeMtk0ng,cutting,cutting,42,60,18
eYrOeMtk0ng,cutting,cutting,71,155,84
eYrOeMtk0ng,cutting,cutting,185,245,60
eYrOeMtk0ng,tying,tying,485,510,25
eYrOeMtk0ng,tying,tying,520,530,10
eYrOeMtk0ng,tying,tying,580,590,10
eYrOeMtk0ng,tying,tying,690,705,15
eYrOeMtk0ng,tying,tying,755,767,12
eYrOeMtk0ng,tying,tying,800,810,10
eYrOeMtk0ng,tying,tying,820,830,10
eYrOeMtk0ng,tying,tying,880,890,10
eYrOeMtk0ng,suturing,suturing,262,283,21
eYrOeMtk0ng,suturing,suturing,390,410,20
eYrOeMtk0ng,suturing,suturing,420,472,52
eYrOeMtk0ng,suturing,suturing,540,573,33
eYrOeMtk0ng,suturing,suturing,650,661,11
eYrOeMtk0ng,tying,suturing,662,667,5
eYrOeMtk0ng,suturing,suturing,668,690,22
eYrOeMtk0ng,suturing,suturing,746,755,9
eYrOeMtk0ng,suturing,suturing,792,800,8
eYrOeMtk0ng,,suturing,810,820,10
eYrOeMtk0ng,,suturing,840,842,2
AGxuM1_H7KE,cutting,cutting,8,27,19
AGxuM1_H7KE,cutting,cutting,61,70,9
AGxuM1_H7KE,,cutting,125,129,4
AGxuM1_H7KE,cutting,cutting,134,162,28
AGxuM1_H7KE,cutting,cutting,186,230,44
AGxuM1_H7KE,cutting,cutting,266,298,32
AGxuM1_H7KE,cutting,cutting,482,490,8
AGxuM1_H7KE,,cutting,504,508,4
AGxuM1_H7KE,cutting,cutting,546,569,23
AGxuM1_H7KE,cutting,tying,376,386,10
AGxuM1_H7KE,tying,tying,422,432,10
AGxuM1_H7KE,tying,tying,465,477,12
AGxuM1_H7KE,tying,tying,492,498,6
AGxuM1_H7KE,tying,tying,531,540,9
AGxuM1_H7KE,tying,tying,736,744,8
AGxuM1_H7KE,,tying,767,769,2
AGxuM1_H7KE,tying,tying,907,940,33
AGxuM1_H7KE,,tying,955,959,4
AGxuM1_H7KE,suturing,suturing,718,729,11
AGxuM1_H7KE,suturing,suturing,755,760,5
AGxuM1_H7KE,suturing,suturing,799,899,100
AGxuM1_H7KE,none,suturing,944,954,10
JvyO1LjGKhs,,cutting,50,75,25
JvyO1LjGKhs,,cutting,79,102,23
JvyO1LjGKhs,,cutting,114,136,22
JvyO1LjGKhs,,cutting,150,160,10
JvyO1LjGKhs,,cutting,210,260,50
JvyO1LjGKhs,,cutting,277,288,11
JvyO1LjGKhs,,cutting,315,345,30
JvyO1LjGKhs,,cutting,390,425,35
JvyO1LjGKhs,,tying,551,560,9
JvyO1LjGKhs,,tying,582,595,13
JvyO1LjGKhs,,suturing,437,510,73
JvyO1LjGKhs,,suturing,618,630,12
BdLSt0VARKU,cutting,cutting,5,16,11
BdLSt0VARKU,cutting,cutting,45,59,14
wZ2LvPEP84g,,cutting,350,360,10
wZ2LvPEP84g,,tying,444,459,15
wZ2LvPEP84g,,tying,473,483,10
wZ2LvPEP84g,,tying,495,508,13
wZ2LvPEP84g,,tying,515,525,10
wZ2LvPEP84g,,tying,640,649,9
wZ2LvPEP84g,,tying,692,699,7
wZ2LvPEP84g,,tying,708,718,10
wZ2LvPEP84g,,tying,755,760,5
wZ2LvPEP84g,,suturing,465,472,7
wZ2LvPEP84g,,suturing,623,640,17
wZ2LvPEP84g,,suturing,645,655,10
wZ2LvPEP84g,,suturing,703,708,5
wZ2LvPEP84g,,suturing,738,755,17
cdYW87IozMA,cutting,cutting,0,14,14
8LGGfKHtiPc,,cutting,0,13,13
8LGGfKHtiPc,,cutting,19,32,13
8LGGfKHtiPc,,tying,60,73,13
8LGGfKHtiPc,,tying,92,98,6
8LGGfKHtiPc,,tying,120,122,2
8LGGfKHtiPc,,suturing,50,60,10
8LGGfKHtiPc,,suturing,85,92,7
8LGGfKHtiPc,,suturing,109,119,10
8LGGfKHtiPc,,suturing,141,150,9
G3fOG8CcKEw,,cutting,16,21,5
G3fOG8CcKEw,none,cutting,39,50,11
G3fOG8CcKEw,cutting,cutting,65,94,29
HW2LXjSoAc8,cutting,cutting,12,53,41
HW2LXjSoAc8,none,cutting,54,59,5
HW2LXjSoAc8,cutting,cutting,60,107,47
HW2LXjSoAc8,none,cutting,108,113,5
HW2LXjSoAc8,cutting,cutting,114,152,38
HW2LXjSoAc8,suturing,suturing,177,207,30
a4M6zT_PTQg,cutting,cutting,0,81,81
a4M6zT_PTQg,tying,tying,102,118,16
a4M6zT_PTQg,tying,tying,218,243,25
a4M6zT_PTQg,none,suturing,88,93,5
a4M6zT_PTQg,suturing,suturing,94,102,8
a4M6zT_PTQg,suturing,suturing,118,217,99
bfZWsulahkQ,,cutting,49,57,8
bfZWsulahkQ,,cutting,60,62,2
bfZWsulahkQ,cutting,cutting,88,113,25
bfZWsulahkQ,tying,tying,70,84,14
bfZWsulahkQ,tying,tying,138,152,14
bfZWsulahkQ,tying,tying,165,186,21
bfZWsulahkQ,,suturing,68,70,2
bfZWsulahkQ,suturing,suturing,117,128,11
bfZWsulahkQ,tying,suturing,129,138,9
bfZWsulahkQ,suturing,suturing,153,158,5
iONoQhdgIf0,cutting,cutting,0,53,53
iONoQhdgIf0,none,cutting,54,59,5
iONoQhdgIf0,cutting,cutting,60,95,35
iONoQhdgIf0,none,cutting,96,101,5
iONoQhdgIf0,cutting,cutting,102,413,311
iONoQhdgIf0,none,cutting,414,419,5
iONoQhdgIf0,cutting,cutting,420,488,68
iONoQhdgIf0,cutting,cutting,489,524,35
iONoQhdgIf0,none,cutting,525,650,125
iONoQhdgIf0,cutting,cutting,651,656,5
iONoQhdgIf0,none,cutting,657,752,95
iONoQhdgIf0,cutting,cutting,753,776,23
iONoQhdgIf0,none,cutting,777,782,5
iONoQhdgIf0,cutting,cutting,783,806,23
iONoQhdgIf0,tying,cutting,807,836,29
iONoQhdgIf0,cutting,cutting,837,862,25
iONoQhdgIf0,cutting,cutting,863,970,107
iONoQhdgIf0,none,cutting,971,1126,155
iONoQhdgIf0,cutting,cutting,1127,1270,143
iONoQhdgIf0,none,cutting,1271,1306,35
iONoQhdgIf0,cutting,cutting,1307,1360,53
iONoQhdgIf0,none,cutting,1361,1366,5
iONoQhdgIf0,cutting,cutting,1367,1408,41
iONoQhdgIf0,none,cutting,1409,1474,65
iONoQhdgIf0,cutting,cutting,1475,1498,23
iONoQhdgIf0,none,cutting,1499,1504,5
iONoQhdgIf0,cutting,cutting,1505,1570,65
iONoQhdgIf0,none,cutting,1571,1600,29
iONoQhdgIf0,cutting,cutting,1601,1624,23
iONoQhdgIf0,none,cutting,1625,1630,5
iONoQhdgIf0,cutting,cutting,1631,1660,29
iONoQhdgIf0,none,cutting,1661,1670,9
BWrTbbZYozw,,cutting,55,62,7
BWrTbbZYozw,,cutting,70,75,5
BWrTbbZYozw,,cutting,163,169,6
BWrTbbZYozw,,cutting,196,200,4
BWrTbbZYozw,,cutting,215,225,10
BWrTbbZYozw,,tying,514,523,9
BWrTbbZYozw,,suturing,90,102,12
EUdac6A9n60,,cutting,75,78,3
EUdac6A9n60,cutting,cutting,118,125,7
EUdac6A9n60,cutting,cutting,132,159,27
EUdac6A9n60,tying,tying,286,302,16
EUdac6A9n60,tying,tying,360,366,6
feF1aRtVAvc,cutting,cutting,14,73,59
feF1aRtVAvc,cutting,cutting,100,110,10
feF1aRtVAvc,tying,tying,214,227,13
feF1aRtVAvc,tying,tying,402,415,13
feF1aRtVAvc,tying,tying,491,503,12
feF1aRtVAvc,tying,suturing,502,507,5
feF1aRtVAvc,suturing,suturing,508,553,45
feF1aRtVAvc,suturing,suturing,559,589,30
feF1aRtVAvc,suturing,suturing,608,660,52
feF1aRtVAvc,suturing,suturing,670,675,5
feF1aRtVAvc,tying,suturing,676,684,8
feF1aRtVAvc,suturing,suturing,690,795,105
pkvyOtGIbV8,cutting,cutting,25,46,21
pkvyOtGIbV8,cutting,cutting,97,102,5
pkvyOtGIbV8,none,cutting,103,108,5
pkvyOtGIbV8,cutting,cutting,109,126,17
pkvyOtGIbV8,none,cutting,127,138,11
pkvyOtGIbV8,cutting,cutting,139,192,53
pkvyOtGIbV8,,suturing,226,230,4
0oxhRpSq850,cutting,cutting,16,24,8
0oxhRpSq850,cutting,cutting,60,70,10
0oxhRpSq850,cutting,cutting,98,114,16
0oxhRpSq850,cutting,cutting,158,169,11
0oxhRpSq850,suturing,suturing,198,236,38
pN5bKT7U_OQ,cutting,cutting,28,33,5
pN5bKT7U_OQ,none,cutting,34,39,5
pN5bKT7U_OQ,cutting,cutting,40,76,36
pN5bKT7U_OQ,cutting,cutting,124,145,21
pN5bKT7U_OQ,none,tying,448,470,22
pN5bKT7U_OQ,tying,suturing,235,246,11
pN5bKT7U_OQ,suturing,suturing,247,264,17
pN5bKT7U_OQ,tying,suturing,265,270,5
pN5bKT7U_OQ,suturing,suturing,271,288,17
pN5bKT7U_OQ,tying,suturing,289,300,11
pN5bKT7U_OQ,suturing,suturing,301,318,17
pN5bKT7U_OQ,tying,suturing,319,330,11
pN5bKT7U_OQ,suturing,suturing,331,354,23
pN5bKT7U_OQ,tying,suturing,355,366,11
pN5bKT7U_OQ,suturing,suturing,367,390,23
pN5bKT7U_OQ,none,suturing,391,396,5
pN5bKT7U_OQ,tying,suturing,397,414,17
pN5bKT7U_OQ,suturing,suturing,415,434,19
pN5bKT7U_OQ,suturing,suturing,473,478,5
pN5bKT7U_OQ,tying,suturing,479,490,11
pN5bKT7U_OQ,suturing,suturing,491,556,65
thgXniYmwII,,cutting,12,17,5
thgXniYmwII,,cutting,40,42,2
thgXniYmwII,,cutting,52,56,4
thgXniYmwII,,tying,83,88,5
thgXniYmwII,,suturing,91,96,5
JjzptNEQJ2g,cutting,cutting,75,97,22
JjzptNEQJ2g,cutting,cutting,136,154,18
hKgkoj8kaHo,cutting,cutting,85,108,23
hKgkoj8kaHo,none,cutting,109,120,11
hKgkoj8kaHo,cutting,cutting,121,156,35
hKgkoj8kaHo,none,cutting,157,186,29
hKgkoj8kaHo,cutting,cutting,187,204,17
hKgkoj8kaHo,suturing,suturing,220,231,11
hKgkoj8kaHo,tying,suturing,232,240,8
TcYgRmsw_jg,cutting,cutting,12,65,53
TcYgRmsw_jg,,suturing,224,225,1
TcYgRmsw_jg,suturing,suturing,229,239,10
1YvFWU90eaE,,cutting,0,19,19
1YvFWU90eaE,,cutting,275,287,12
1YvFWU90eaE,,cutting,322,536,214
hSZOq0uqO6s,cutting,cutting,41,75,34
oDs_6O6AQjA,cutting,cutting,78,131,53
oDs_6O6AQjA,cutting,cutting,138,174,36
oDs_6O6AQjA,tying,tying,209,219,10
oDs_6O6AQjA,tying,tying,227,239,12
oDs_6O6AQjA,tying,tying,251,260,9
oDs_6O6AQjA,tying,tying,270,280,10
oDs_6O6AQjA,tying,tying,292,300,8
oDs_6O6AQjA,suturing,suturing,196,209,13
oDs_6O6AQjA,suturing,suturing,220,226,6
oDs_6O6AQjA,suturing,suturing,241,250,9
oDs_6O6AQjA,suturing,suturing,261,269,8
oDs_6O6AQjA,suturing,suturing,281,286,5
LVMCtRCJibI,cutting,cutting,31,45,14
LVMCtRCJibI,cutting,cutting,47,77,30
LVMCtRCJibI,cutting,cutting,93,101,8
LVMCtRCJibI,cutting,cutting,150,155,5
LVMCtRCJibI,cutting,cutting,177,194,17
LVMCtRCJibI,cutting,cutting,255,260,5
LVMCtRCJibI,cutting,cutting,615,623,8
LVMCtRCJibI,tying,suturing,673,681,8
LVMCtRCJibI,,suturing,681,710,29
luDl5dLz1No,cutting,cutting,359,373,14
luDl5dLz1No,,cutting,374,375,1
luDl5dLz1No,cutting,cutting,502,512,10
luDl5dLz1No,,cutting,1109,1111,2
luDl5dLz1No,tying,tying,1011,1033,22
luDl5dLz1No,tying,tying,1142,1165,23
luDl5dLz1No,tying,tying,1213,1218,5
luDl5dLz1No,tying,tying,1256,1261,5
luDl5dLz1No,tying,tying,1289,1294,5
luDl5dLz1No,tying,tying,1320,1330,10
luDl5dLz1No,tying,tying,1355,1375,20
luDl5dLz1No,tying,tying,1399,1409,10
luDl5dLz1No,,suturing,1137,1140,3
luDl5dLz1No,suturing,suturing,1188,1207,19
luDl5dLz1No,suturing,suturing,1233,1252,19
luDl5dLz1No,suturing,suturing,1271,1286,15
luDl5dLz1No,suturing,suturing,1306,1311,5
luDl5dLz1No,suturing,suturing,1338,1352,14
luDl5dLz1No,suturing,suturing,1379,1395,16
hGZez6oxS9E,cutting,cutting,131,158,27
hGZez6oxS9E,cutting,cutting,175,322,147
hGZez6oxS9E,cutting,cutting,356,372,16
hGZez6oxS9E,cutting,cutting,451,456,5
hGZez6oxS9E,tying,tying,414,441,27
hGZez6oxS9E,tying,tying,700,715,15
hGZez6oxS9E,tying,tying,750,777,27
hGZez6oxS9E,tying,tying,944,958,14
hGZez6oxS9E,tying,tying,974,993,19
hGZez6oxS9E,tying,suturing,384,390,6
hGZez6oxS9E,suturing,suturing,1176,1202,26
hGZez6oxS9E,suturing,suturing,1214,1254,40
hGZez6oxS9E,none,suturing,799,822,23
hGZez6oxS9E,cutting,suturing,823,846,23
hGZez6oxS9E,none,suturing,847,852,5
hGZez6oxS9E,cutting,suturing,853,899,46
ifywgQA-0t8,cutting,cutting,11,16,5
ifywgQA-0t8,cutting,cutting,34,46,12
ifywgQA-0t8,cutting,cutting,63,98,35
rzKGRcXNXm4,,tying,315,324,9
rzKGRcXNXm4,suturing,suturing,150,175,25
rzKGRcXNXm4,,suturing,235,246,11
rzKGRcXNXm4,,suturing,251,270,19
rzKGRcXNXm4,,suturing,280,286,6
rzKGRcXNXm4,,suturing,295,304,9
rzKGRcXNXm4,,suturing,311,314,3
8eFljZ449SY,cutting,cutting,13,22,9
8eFljZ449SY,cutting,cutting,41,50,9
8eFljZ449SY,cutting,cutting,58,79,21
8eFljZ449SY,cutting,cutting,91,122,31
8eFljZ449SY,cutting,cutting,149,159,10
8eFljZ449SY,,cutting,163,166,3
8eFljZ449SY,,cutting,178,183,5
8eFljZ449SY,cutting,cutting,191,215,24
8eFljZ449SY,cutting,cutting,258,271,13
8eFljZ449SY,tying,tying,309,314,5
8eFljZ449SY,suturing,suturing,302,309,7
8eFljZ449SY,,suturing,321,406,85
iI09BTuD3xU,cutting,cutting,17,30,13
iI09BTuD3xU,cutting,cutting,40,60,20
iI09BTuD3xU,cutting,cutting,90,112,22
iI09BTuD3xU,cutting,cutting,187,216,29
iI09BTuD3xU,cutting,cutting,251,265,14
iI09BTuD3xU,cutting,cutting,325,332,7
iI09BTuD3xU,cutting,cutting,472,482,10
ytgWAMS1SkE,suturing,suturing,573,590,17
ytgWAMS1SkE,tying,suturing,591,626,35
ytgWAMS1SkE,suturing,suturing,627,668,41
ytgWAMS1SkE,tying,suturing,669,692,23
ytgWAMS1SkE,suturing,suturing,693,728,35
ytgWAMS1SkE,tying,suturing,729,752,23
ytgWAMS1SkE,suturing,suturing,753,764,11
ytgWAMS1SkE,tying,suturing,765,788,23
ytgWAMS1SkE,suturing,suturing,789,806,17
ytgWAMS1SkE,none,suturing,807,812,5
ytgWAMS1SkE,suturing,suturing,813,829,16
wy7Q_xUlwHI,,cutting,220,225,5
wy7Q_xUlwHI,,tying,66,80,14
wy7Q_xUlwHI,,tying,180,192,12
wy7Q_xUlwHI,,tying,266,279,13
wy7Q_xUlwHI,,tying,460,475,15
wy7Q_xUlwHI,,tying,510,530,20
wy7Q_xUlwHI,,tying,639,654,15
wy7Q_xUlwHI,,tying,680,697,17
wy7Q_xUlwHI,,tying,729,749,20
wy7Q_xUlwHI,,tying,777,793,16
wy7Q_xUlwHI,,tying,818,839,21
wy7Q_xUlwHI,,tying,858,870,12
wy7Q_xUlwHI,,tying,900,910,10
wy7Q_xUlwHI,,tying,929,941,12
wy7Q_xUlwHI,,tying,1068,1090,22
wy7Q_xUlwHI,,tying,1114,1128,14
wy7Q_xUlwHI,,tying,1142,1155,13
wy7Q_xUlwHI,,tying,1181,1200,19
wy7Q_xUlwHI,,tying,1229,1246,17
wy7Q_xUlwHI,,suturing,0,18,18
wy7Q_xUlwHI,,suturing,39,62,23
wy7Q_xUlwHI,,suturing,88,112,24
wy7Q_xUlwHI,,suturing,134,180,46
wy7Q_xUlwHI,,suturing,200,219,19
wy7Q_xUlwHI,,suturing,231,265,34
wy7Q_xUlwHI,,suturing,395,407,12
wy7Q_xUlwHI,,suturing,435,459,24
wy7Q_xUlwHI,,suturing,488,509,21
wy7Q_xUlwHI,,suturing,570,610,40
wy7Q_xUlwHI,,suturing,618,635,17
wy7Q_xUlwHI,,suturing,669,679,10
wy7Q_xUlwHI,,suturing,711,728,17
wy7Q_xUlwHI,,suturing,760,775,15
wy7Q_xUlwHI,,suturing,805,817,12
wy7Q_xUlwHI,,suturing,845,857,12
wy7Q_xUlwHI,,suturing,879,895,16
wy7Q_xUlwHI,,suturing,915,927,12
wy7Q_xUlwHI,,suturing,967,974,7
wy7Q_xUlwHI,,suturing,1019,1027,8
wy7Q_xUlwHI,,suturing,1054,1067,13
wy7Q_xUlwHI,,suturing,1104,1113,9
wy7Q_xUlwHI,,suturing,1137,1141,4
wy7Q_xUlwHI,,suturing,1173,1180,7
wy7Q_xUlwHI,,suturing,1220,1228,8
wy7Q_xUlwHI,,suturing,1258,1270,12
mYzL383plFw,,cutting,65,70,5
mYzL383plFw,cutting,cutting,78,120,42
mYzL383plFw,cutting,cutting,280,293,13
mYzL383plFw,cutting,cutting,350,490,140
mYzL383plFw,suturing,cutting,530,560,30
mYzL383plFw,suturing,cutting,580,604,24
mYzL383plFw,tying,tying,217,237,20
P-qQJChzlhM,cutting,cutting,115,170,55
P-qQJChzlhM,cutting,cutting,220,230,10
P-qQJChzlhM,cutting,cutting,243,278,35
P-qQJChzlhM,none,cutting,279,284,5
P-qQJChzlhM,cutting,cutting,285,300,15
P-qQJChzlhM,cutting,cutting,319,440,121
P-qQJChzlhM,tying,tying,186,195,9
P-qQJChzlhM,tying,tying,464,473,9
P-qQJChzlhM,suturing,suturing,180,186,6
P-qQJChzlhM,suturing,suturing,442,447,5
P-qQJChzlhM,tying,suturing,448,460,12
DHFI6YnauIM,,cutting,737,742,5
DHFI6YnauIM,,cutting,823,880,57
DHFI6YnauIM,,tying,802,810,8
DHFI6YnauIM,,suturing,793,802,9
DHFI6YnauIM,,suturing,1065,1075,10
DHFI6YnauIM,,suturing,1098,1108,10
DHFI6YnauIM,,suturing,1109,1150,41
DHFI6YnauIM,,suturing,1165,1190,25
1yd_OrU2apY,cutting,cutting,61,68,7
1yd_OrU2apY,cutting,cutting,73,96,23
1yd_OrU2apY,cutting,cutting,110,159,49
1yd_OrU2apY,cutting,cutting,163,192,29
1yd_OrU2apY,cutting,cutting,213,310,97
1yd_OrU2apY,cutting,cutting,368,458,90
1yd_OrU2apY,cutting,cutting,473,481,8
1yd_OrU2apY,cutting,cutting,514,529,15
1yd_OrU2apY,cutting,cutting,540,546,6
1yd_OrU2apY,,cutting,557,562,5
1yd_OrU2apY,,cutting,568,572,4
1yd_OrU2apY,cutting,cutting,604,612,8
1yd_OrU2apY,cutting,cutting,625,633,8
1yd_OrU2apY,cutting,cutting,645,658,13
1yd_OrU2apY,,cutting,664,669,5
1yd_OrU2apY,cutting,cutting,859,880,21
1yd_OrU2apY,cutting,cutting,883,894,11
1yd_OrU2apY,cutting,cutting,1031,1074,43
1yd_OrU2apY,tying,tying,715,745,30
1yd_OrU2apY,tying,tying,927,944,17
1yd_OrU2apY,tying,tying,968,975,7
1yd_OrU2apY,tying,tying,990,1000,10
1yd_OrU2apY,tying,tying,1095,1124,29
1yd_OrU2apY,,tying,1138,1142,4
1yd_OrU2apY,suturing,suturing,700,714,14
1yd_OrU2apY,suturing,suturing,905,926,21
1yd_OrU2apY,suturing,suturing,955,967,12
1yd_OrU2apY,suturing,suturing,976,981,5
1yd_OrU2apY,suturing,suturing,1080,1093,13
1yd_OrU2apY,,suturing,1152,1153,1
opbgCSvNKfY,cutting,cutting,67,88,21
opbgCSvNKfY,cutting,cutting,92,105,13
opbgCSvNKfY,cutting,cutting,107,126,19
opbgCSvNKfY,,cutting,139,144,5
opbgCSvNKfY,cutting,cutting,152,160,8
opbgCSvNKfY,cutting,cutting,164,172,8
opbgCSvNKfY,cutting,cutting,179,246,67
opbgCSvNKfY,,cutting,272,275,3
opbgCSvNKfY,cutting,cutting,317,339,22
opbgCSvNKfY,cutting,cutting,341,351,10
opbgCSvNKfY,,cutting,354,357,3
opbgCSvNKfY,cutting,cutting,360,374,14
opbgCSvNKfY,cutting,cutting,384,390,6
opbgCSvNKfY,,cutting,401,404,3
opbgCSvNKfY,cutting,cutting,535,547,12
opbgCSvNKfY,cutting,cutting,550,575,25
opbgCSvNKfY,cutting,cutting,581,601,20
opbgCSvNKfY,,cutting,605,606,1
opbgCSvNKfY,cutting,cutting,609,626,17
opbgCSvNKfY,cutting,cutting,634,640,6
opbgCSvNKfY,,cutting,744,746,2
opbgCSvNKfY,tying,tying,670,685,15
opbgCSvNKfY,tying,tying,692,699,7
opbgCSvNKfY,tying,tying,778,784,6
opbgCSvNKfY,suturing,suturing,423,428,5
opbgCSvNKfY,tying,suturing,438,460,22
opbgCSvNKfY,suturing,suturing,648,658,10
opbgCSvNKfY,,suturing,660,665,5
opbgCSvNKfY,suturing,suturing,763,772,9
opbgCSvNKfY,,suturing,792,793,1
opbgCSvNKfY,,suturing,806,807,1
KUKObgS39yA,cutting,cutting,67,85,18
KUKObgS39yA,cutting,cutting,94,111,17
KUKObgS39yA,cutting,cutting,139,152,13
KUKObgS39yA,cutting,cutting,170,187,17
KUKObgS39yA,cutting,cutting,210,265,55
KUKObgS39yA,cutting,cutting,274,279,5
KUKObgS39yA,none,cutting,280,285,5
KUKObgS39yA,cutting,cutting,286,310,24
KUKObgS39yA,cutting,cutting,326,343,17
KUKObgS39yA,none,cutting,344,350,6
KUKObgS39yA,cutting,cutting,360,407,47
KUKObgS39yA,,cutting,435,437,2
KUKObgS39yA,cutting,cutting,460,510,50
KUKObgS39yA,cutting,cutting,538,549,11
KUKObgS39yA,none,cutting,550,560,10
KUKObgS39yA,,cutting,568,573,5
KUKObgS39yA,cutting,cutting,653,708,55
KUKObgS39yA,cutting,cutting,729,739,10
KUKObgS39yA,cutting,cutting,850,860,10
KUKObgS39yA,tying,tying,775,799,24
KUKObgS39yA,tying,tying,872,886,14
KUKObgS39yA,,tying,911,913,2
KUKObgS39yA,suturing,suturing,754,774,20
KUKObgS39yA,suturing,suturing,898,910,12
WR8G3F2TDxI,cutting,cutting,19,34,15
WR8G3F2TDxI,cutting,cutting,40,48,8
WR8G3F2TDxI,,cutting,51,56,5
WR8G3F2TDxI,cutting,cutting,65,78,13
WR8G3F2TDxI,cutting,cutting,85,122,37
WR8G3F2TDxI,,cutting,134,138,4
WR8G3F2TDxI,,cutting,302,307,5
WR8G3F2TDxI,cutting,cutting,389,425,36
WR8G3F2TDxI,suturing,suturing,317,327,10
WR8G3F2TDxI,,suturing,355,360,5
WR8G3F2TDxI,suturing,suturing,639,650,11
WR8G3F2TDxI,tying,suturing,651,656,5
WR8G3F2TDxI,suturing,suturing,657,673,16
7d19RiHEBjQ,cutting,cutting,6,22,16
QjYdLDYs4JI,,cutting,17,116,99
QjYdLDYs4JI,,cutting,126,315,189
QjYdLDYs4JI,,suturing,374,386,12
QjYdLDYs4JI,,suturing,400,404,4
QjYdLDYs4JI,,suturing,442,448,6
OMK_iNu3gIE,,cutting,68,250,182
OMK_iNu3gIE,,cutting,272,293,21
OMK_iNu3gIE,,cutting,311,316,5
OMK_iNu3gIE,,cutting,328,379,51
OMK_iNu3gIE,,cutting,384,555,171
OMK_iNu3gIE,,tying,632,646,14
OMK_iNu3gIE,,tying,653,665,12
OMK_iNu3gIE,,tying,673,676,3
OMK_iNu3gIE,,suturing,618,631,13
OMK_iNu3gIE,,suturing,668,672,4
OMK_iNu3gIE,,suturing,691,700,9
KlFRPypF1kg,cutting,cutting,37,123,86
KlFRPypF1kg,cutting,cutting,143,244,101
KlFRPypF1kg,none,cutting,245,262,17
KlFRPypF1kg,cutting,cutting,263,304,41
KlFRPypF1kg,none,cutting,305,310,5
KlFRPypF1kg,cutting,cutting,311,364,53
KlFRPypF1kg,none,cutting,365,370,5
KlFRPypF1kg,cutting,cutting,371,413,42
KlFRPypF1kg,cutting,cutting,496,959,463
KlFRPypF1kg,cutting,cutting,981,990,9
KlFRPypF1kg,tying,tying,123,134,11
KlFRPypF1kg,tying,tying,414,432,18
KlFRPypF1kg,tying,tying,450,464,14
KlFRPypF1kg,tying,tying,1000,1006,6
KlFRPypF1kg,suturing,tying,1023,1028,5
KlFRPypF1kg,tying,tying,1029,1051,22
KlFRPypF1kg,tying,tying,1061,1076,15
KlFRPypF1kg,suturing,suturing,439,444,5
KlFRPypF1kg,suturing,suturing,464,495,31
KlFRPypF1kg,suturing,suturing,991,998,7
KlFRPypF1kg,suturing,suturing,1013,1022,9
KlFRPypF1kg,suturing,suturing,1052,1060,8
KlFRPypF1kg,suturing,suturing,1077,1106,29
mq8pdoUFZ8g,cutting,cutting,78,110,32
wEivan1FAIA,cutting,cutting,108,135,27
wEivan1FAIA,cutting,cutting,140,188,48
wEivan1FAIA,cutting,cutting,241,266,25
wEivan1FAIA,,suturing,411,414,3
DpeAsOXVruw,cutting,cutting,157,165,8
DpeAsOXVruw,cutting,cutting,170,180,10
DpeAsOXVruw,cutting,cutting,258,264,6
DpeAsOXVruw,tying,tying,331,337,6
DpeAsOXVruw,,tying,339,341,2
DpeAsOXVruw,tying,tying,409,416,7
DpeAsOXVruw,,suturing,208,213,5
DpeAsOXVruw,suturing,suturing,218,227,9
DpeAsOXVruw,,suturing,240,243,3
DpeAsOXVruw,,suturing,250,251,1
DpeAsOXVruw,suturing,suturing,396,408,12
DpeAsOXVruw,,suturing,419,424,5
VvkCaxXqFfY,cutting,cutting,31,150,119
VvkCaxXqFfY,none,cutting,151,162,11
VvkCaxXqFfY,cutting,cutting,163,169,6
VvkCaxXqFfY,tying,suturing,182,190,8
5cscLtlF-P0,cutting,cutting,126,207,81
5cscLtlF-P0,cutting,cutting,414,450,36
5cscLtlF-P0,cutting,cutting,564,595,31
5cscLtlF-P0,cutting,cutting,600,610,10
5cscLtlF-P0,tying,tying,746,760,14
5cscLtlF-P0,suturing,suturing,730,745,15
CkKu-f_HknQ,cutting,cutting,5,61,56
CkKu-f_HknQ,,cutting,72,76,4
CkKu-f_HknQ,cutting,cutting,105,152,47
BssDb0s5cdA,cutting,cutting,5,17,12
BssDb0s5cdA,cutting,cutting,43,55,12
frw2-77Iwf0,,cutting,180,192,12
frw2-77Iwf0,,cutting,192,205,13
frw2-77Iwf0,,cutting,206,218,12
frw2-77Iwf0,,cutting,218,248,30
frw2-77Iwf0,,cutting,248,280,32
frw2-77Iwf0,cutting,cutting,280,300,20
frw2-77Iwf0,suturing,suturing,305,310,5
frw2-77Iwf0,tying,suturing,311,316,5
frw2-77Iwf0,suturing,suturing,317,334,17
frw2-77Iwf0,tying,suturing,335,340,5
frw2-77Iwf0,suturing,suturing,341,346,5
frw2-77Iwf0,tying,suturing,347,363,16
-DGQsmwXmLg,cutting,cutting,96,191,95
KzPl-2e5Mw0,,cutting,140,148,8
d8xavK1zIhY,cutting,cutting,38,47,9
d8xavK1zIhY,,cutting,49,52,3
d8xavK1zIhY,cutting,cutting,60,69,9
d8xavK1zIhY,cutting,cutting,130,149,19
d8xavK1zIhY,cutting,cutting,240,245,5
d8xavK1zIhY,cutting,cutting,491,498,7
d8xavK1zIhY,,cutting,507,511,4
d8xavK1zIhY,,cutting,540,545,5
d8xavK1zIhY,cutting,cutting,639,648,9
d8xavK1zIhY,cutting,cutting,715,726,11
d8xavK1zIhY,,cutting,804,806,2
d8xavK1zIhY,cutting,cutting,914,919,5
d8xavK1zIhY,none,cutting,920,925,5
d8xavK1zIhY,cutting,cutting,926,948,22
uGT08nyk7qA,cutting,cutting,302,316,14
uGT08nyk7qA,cutting,cutting,532,550,18
urMq4AtExDg,cutting,cutting,198,448,250
urMq4AtExDg,cutting,cutting,462,520,58
urMq4AtExDg,cutting,cutting,748,767,19
urMq4AtExDg,cutting,cutting,833,847,14
urMq4AtExDg,tying,tying,550,565,15
urMq4AtExDg,,tying,609,614,5
urMq4AtExDg,suturing,suturing,539,544,5
urMq4AtExDg,suturing,suturing,598,603,5
urMq4AtExDg,suturing,suturing,664,669,5
urMq4AtExDg,tying,suturing,670,675,5
urMq4AtExDg,suturing,suturing,676,681,5
urMq4AtExDg,tying,suturing,682,687,5
urMq4AtExDg,suturing,suturing,688,699,11
urMq4AtExDg,tying,suturing,700,705,5
urMq4AtExDg,suturing,suturing,706,717,11
urMq4AtExDg,tying,suturing,718,734,16
urMq4AtExDg,suturing,suturing,778,789,11
urMq4AtExDg,tying,suturing,790,795,5
urMq4AtExDg,suturing,suturing,796,801,5
urMq4AtExDg,tying,suturing,802,807,5
urMq4AtExDg,suturing,suturing,808,813,5
urMq4AtExDg,tying,suturing,814,819,5
aqPrL_RJPC4,cutting,cutting,7,12,5
aqPrL_RJPC4,,cutting,24,28,4
aqPrL_RJPC4,cutting,cutting,33,44,11
aqPrL_RJPC4,cutting,cutting,52,63,11
aqPrL_RJPC4,none,cutting,64,69,5
aqPrL_RJPC4,cutting,cutting,70,79,9
aqPrL_RJPC4,cutting,cutting,109,121,12
aqPrL_RJPC4,cutting,cutting,127,157,30
aqPrL_RJPC4,cutting,cutting,182,214,32
aqPrL_RJPC4,,cutting,223,226,3
aqPrL_RJPC4,,cutting,262,265,3
aqPrL_RJPC4,suturing,suturing,431,448,17
aqPrL_RJPC4,tying,suturing,449,454,5
aqPrL_RJPC4,suturing,suturing,455,466,11
aqPrL_RJPC4,tying,suturing,467,482,15
aqPrL_RJPC4,suturing,suturing,488,496,8
SublDZXJ7p4,cutting,cutting,308,316,8
SublDZXJ7p4,,cutting,319,322,3
SublDZXJ7p4,,cutting,336,338,2
SublDZXJ7p4,,cutting,365,368,3
SublDZXJ7p4,,cutting,566,570,4
SublDZXJ7p4,suturing,suturing,1050,1056,6
SublDZXJ7p4,,suturing,1061,1066,5
SublDZXJ7p4,suturing,suturing,1074,1082,8
qz_dOdnqAnk,,cutting,262,270,8
qz_dOdnqAnk,,tying,756,762,6
qz_dOdnqAnk,,tying,765,775,10
qz_dOdnqAnk,,tying,1330,1342,12
qz_dOdnqAnk,,tying,1440,1446,6
qz_dOdnqAnk,,tying,2560,2576,16
qz_dOdnqAnk,,tying,2710,2720,10
qz_dOdnqAnk,,tying,2830,2850,20
qz_dOdnqAnk,,tying,2880,2898,18
qz_dOdnqAnk,,tying,2925,2940,15
qz_dOdnqAnk,,suturing,2548,2560,12
qz_dOdnqAnk,,suturing,2590,2710,120
qz_dOdnqAnk,,suturing,2800,2825,25
qz_dOdnqAnk,,suturing,2865,2880,15
qz_dOdnqAnk,,suturing,2910,2925,15
FUGhWj5iv70,,cutting,251,369,118
FUGhWj5iv70,,cutting,397,463,66
FUGhWj5iv70,,cutting,559,640,81
AE2FLFsmoeA,cutting,cutting,78,143,65
AE2FLFsmoeA,none,cutting,150,155,5
AE2FLFsmoeA,cutting,cutting,156,179,23
AE2FLFsmoeA,none,cutting,180,191,11
AE2FLFsmoeA,cutting,cutting,192,251,59
AE2FLFsmoeA,none,cutting,252,263,11
AE2FLFsmoeA,cutting,cutting,264,269,5
AE2FLFsmoeA,none,cutting,270,275,5
AE2FLFsmoeA,cutting,cutting,276,341,65
AE2FLFsmoeA,none,cutting,342,347,5
AE2FLFsmoeA,cutting,cutting,348,359,11
AE2FLFsmoeA,none,cutting,360,365,5
AE2FLFsmoeA,cutting,cutting,366,413,47
AE2FLFsmoeA,none,cutting,414,431,17
AE2FLFsmoeA,cutting,cutting,432,450,18
AE2FLFsmoeA,cutting,cutting,705,728,23
AE2FLFsmoeA,none,cutting,729,740,11
AE2FLFsmoeA,cutting,cutting,741,818,77
AE2FLFsmoeA,none,cutting,819,842,23
AE2FLFsmoeA,cutting,cutting,843,908,65
AE2FLFsmoeA,none,cutting,909,914,5
AE2FLFsmoeA,cutting,cutting,915,944,29
AE2FLFsmoeA,none,cutting,945,980,35
AE2FLFsmoeA,cutting,cutting,981,1068,87
k0f8x5ZFnDs,cutting,cutting,53,59,6
k0f8x5ZFnDs,,cutting,64,66,2
k0f8x5ZFnDs,,cutting,71,75,4
k0f8x5ZFnDs,cutting,cutting,82,97,15
k0f8x5ZFnDs,cutting,cutting,119,138,19
k0f8x5ZFnDs,cutting,cutting,160,175,15
k0f8x5ZFnDs,cutting,cutting,194,202,8
k0f8x5ZFnDs,cutting,cutting,209,216,7
k0f8x5ZFnDs,cutting,cutting,229,237,8
BHerDVFqrL8,cutting,cutting,16,99,83
BHerDVFqrL8,none,cutting,100,105,5
BHerDVFqrL8,cutting,cutting,106,343,237
BHerDVFqrL8,,tying,433,437,4
BHerDVFqrL8,tying,tying,443,450,7
UJzc5o-rXOM,,cutting,235,237,2
UJzc5o-rXOM,tying,tying,365,375,10
UJzc5o-rXOM,tying,suturing,382,387,5
UJzc5o-rXOM,suturing,suturing,388,395,7
nX4--aHdAkM,cutting,cutting,8,41,33
nX4--aHdAkM,cutting,cutting,71,95,24
nX4--aHdAkM,,cutting,102,105,3
nX4--aHdAkM,,cutting,108,111,3
nX4--aHdAkM,,tying,441,446,5
nX4--aHdAkM,,suturing,435,438,3
gL_7N9tvgT4,cutting,cutting,101,133,32
gL_7N9tvgT4,,tying,758,764,6
gL_7N9tvgT4,,tying,769,774,5
gL_7N9tvgT4,suturing,suturing,780,785,5
gL_7N9tvgT4,tying,suturing,815,821,6
hyw7Ue6oW8w,,cutting,45,50,5
hyw7Ue6oW8w,cutting,cutting,75,82,7
hyw7Ue6oW8w,suturing,tying,22,28,6
hyw7Ue6oW8w,suturing,suturing,30,40,10
CAd_n-qgRSI,cutting,cutting,11,224,213
CAd_n-qgRSI,cutting,cutting,235,255,20
CAd_n-qgRSI,cutting,cutting,263,276,13
CAd_n-qgRSI,cutting,cutting,296,301,5
1AwmGrnk-Qs,cutting,cutting,113,145,32
1AwmGrnk-Qs,cutting,cutting,151,161,10
1AwmGrnk-Qs,,cutting,183,188,5
1AwmGrnk-Qs,cutting,cutting,194,215,21
1AwmGrnk-Qs,cutting,cutting,365,429,64
l5h_tOU_D9w,cutting,cutting,6,22,16
-3gFrKiC99I,,cutting,35,36,1
-3gFrKiC99I,,cutting,136,143,7
-3gFrKiC99I,,cutting,148,155,7
-3gFrKiC99I,,cutting,166,187,21
-3gFrKiC99I,,cutting,196,210,14
-3gFrKiC99I,,cutting,217,240,23
-3gFrKiC99I,,cutting,244,247,3
-3gFrKiC99I,,cutting,278,287,9
-3gFrKiC99I,,cutting,289,292,3
-3gFrKiC99I,,cutting,313,315,2
-3gFrKiC99I,,cutting,316,320,4
-3gFrKiC99I,,cutting,334,340,6
-3gFrKiC99I,,cutting,343,349,6
-3gFrKiC99I,,cutting,355,362,7
-3gFrKiC99I,,cutting,380,387,7
-3gFrKiC99I,,cutting,391,395,4
-3gFrKiC99I,,tying,460,469,9
-3gFrKiC99I,,tying,523,528,5
-3gFrKiC99I,,tying,553,558,5
-3gFrKiC99I,,tying,573,578,5
-3gFrKiC99I,,tying,589,593,4
-3gFrKiC99I,,suturing,415,419,4
-3gFrKiC99I,,suturing,441,447,6
-3gFrKiC99I,,suturing,452,456,4
-3gFrKiC99I,,suturing,482,483,1
-3gFrKiC99I,,suturing,494,498,4
-3gFrKiC99I,,suturing,513,518,5
-3gFrKiC99I,,suturing,542,548,6
-3gFrKiC99I,,suturing,564,570,6
-3gFrKiC99I,,suturing,581,584,3
-3gFrKiC99I,,suturing,599,610,11
-3gFrKiC99I,,suturing,613,626,13
-3gFrKiC99I,,suturing,630,635,5
-3gFrKiC99I,,suturing,637,642,5
-3gFrKiC99I,,suturing,653,656,3
-3gFrKiC99I,,suturing,661,666,5
-3gFrKiC99I,,suturing,672,684,12
-3gFrKiC99I,,suturing,689,694,5
-3gFrKiC99I,,suturing,703,704,1
-3gFrKiC99I,,suturing,713,716,3
-3gFrKiC99I,,suturing,723,730,7
-3gFrKiC99I,,suturing,732,736,4
-3gFrKiC99I,,suturing,738,748,10
-3gFrKiC99I,,suturing,753,756,3
-3gFrKiC99I,,suturing,758,764,6
-3gFrKiC99I,,suturing,768,771,3
-3gFrKiC99I,,suturing,779,785,6
-3gFrKiC99I,,suturing,788,793,5
pHLuvSmOJRQ,cutting,cutting,58,64,6
pHLuvSmOJRQ,,cutting,68,72,4
pHLuvSmOJRQ,cutting,cutting,84,92,8
pHLuvSmOJRQ,cutting,cutting,174,181,7
pHLuvSmOJRQ,,cutting,200,203,3
pHLuvSmOJRQ,,cutting,276,280,4
pHLuvSmOJRQ,,cutting,286,289,3
pHLuvSmOJRQ,cutting,cutting,340,346,6
pHLuvSmOJRQ,cutting,cutting,360,372,12
0EeZIRDKYO4,cutting,cutting,16,25,9
0EeZIRDKYO4,cutting,cutting,91,119,28
0sN_jPLnyIE,cutting,cutting,50,72,22
0sN_jPLnyIE,cutting,cutting,79,118,39
1EBmECJP-Vk,cutting,cutting,6,24,18
1EBmECJP-Vk,cutting,cutting,191,203,12
1EBmECJP-Vk,,cutting,223,224,1
1EBmECJP-Vk,cutting,cutting,248,299,51
Xg6vD3vngLQ,cutting,cutting,17,79,62
Xg6vD3vngLQ,cutting,cutting,95,116,21
Tg3Pg6f-mjg,cutting,cutting,21,51,30
Tg3Pg6f-mjg,cutting,tying,87,92,5
Tg3Pg6f-mjg,tying,tying,93,107,14
Tg3Pg6f-mjg,suturing,tying,144,149,5
Tg3Pg6f-mjg,tying,tying,150,176,26
Tg3Pg6f-mjg,tying,tying,269,284,15
Tg3Pg6f-mjg,tying,tying,295,300,5
Tg3Pg6f-mjg,suturing,suturing,250,268,18
Tg3Pg6f-mjg,suturing,suturing,288,294,6
61Le2IPCp6E,,cutting,26,30,4
61Le2IPCp6E,,cutting,38,70,32
61Le2IPCp6E,,tying,253,260,7
61Le2IPCp6E,,tying,273,280,7
61Le2IPCp6E,,tying,299,304,5
61Le2IPCp6E,,suturing,250,252,2
61Le2IPCp6E,,suturing,266,271,5
61Le2IPCp6E,,suturing,288,295,7
2XuCP7jeF7A,cutting,cutting,10,47,37
2XuCP7jeF7A,cutting,cutting,58,89,31
2XuCP7jeF7A,cutting,cutting,96,179,83
2XuCP7jeF7A,cutting,cutting,213,278,65
2XuCP7jeF7A,tying,tying,347,357,10
2XuCP7jeF7A,tying,tying,374,390,16
2XuCP7jeF7A,suturing,suturing,327,347,20
2XuCP7jeF7A,suturing,suturing,365,374,9
2XuCP7jeF7A,suturing,suturing,404,415,11
2XuCP7jeF7A,none,suturing,416,421,5
2XuCP7jeF7A,cutting,suturing,422,432,10
2XuCP7jeF7A,suturing,suturing,440,464,24
lMmYj17LdbM,cutting,cutting,71,76,5
lMmYj17LdbM,cutting,cutting,149,173,24
lMmYj17LdbM,cutting,cutting,210,222,12
nwqyKvQ_mNk,cutting,cutting,87,120,33
nwqyKvQ_mNk,tying,tying,658,664,6
nwqyKvQ_mNk,,tying,693,700,7
nwqyKvQ_mNk,,suturing,673,687,14
nwqyKvQ_mNk,,suturing,717,720,3
5T2o554MNo0,,cutting,0,5,5
5T2o554MNo0,cutting,cutting,17,24,7
5T2o554MNo0,cutting,cutting,45,90,45
5T2o554MNo0,tying,tying,25,35,10
5T2o554MNo0,suturing,suturing,109,120,11
5T2o554MNo0,tying,suturing,121,129,8
8CKX0j-OBl8,,cutting,485,510,25
8CKX0j-OBl8,,cutting,652,690,38
8CKX0j-OBl8,,cutting,750,790,40
8CKX0j-OBl8,,cutting,820,826,6
8CKX0j-OBl8,,tying,638,647,9
8CKX0j-OBl8,,tying,1000,1010,10
8CKX0j-OBl8,,suturing,612,628,16
8CKX0j-OBl8,,suturing,1160,1175,15
0FHE1jSN3w0,cutting,cutting,35,41,6
0FHE1jSN3w0,cutting,cutting,53,66,13
0FHE1jSN3w0,suturing,suturing,1242,1253,11
0FHE1jSN3w0,tying,suturing,1254,1259,5
0FHE1jSN3w0,suturing,suturing,1260,1346,86
0FHE1jSN3w0,suturing,suturing,1374,1386,12
0FHE1jSN3w0,suturing,suturing,1390,1459,69
F5wtY4Ns4nA,cutting,cutting,463,474,11
F5wtY4Ns4nA,cutting,cutting,490,527,37
F5wtY4Ns4nA,cutting,cutting,544,560,16
F5wtY4Ns4nA,cutting,cutting,568,583,15
F5wtY4Ns4nA,cutting,cutting,1105,1120,15
F5wtY4Ns4nA,cutting,cutting,1133,1224,91
F5wtY4Ns4nA,suturing,suturing,896,913,17
F5wtY4Ns4nA,tying,suturing,914,937,23
F5wtY4Ns4nA,none,suturing,938,943,5
F5wtY4Ns4nA,suturing,suturing,944,949,5
F5wtY4Ns4nA,tying,suturing,950,965,15
F5wtY4Ns4nA,suturing,suturing,982,993,11
F5wtY4Ns4nA,tying,suturing,994,1013,19
F5wtY4Ns4nA,suturing,suturing,1023,1028,5
F5wtY4Ns4nA,tying,suturing,1029,1043,14
F5wtY4Ns4nA,suturing,suturing,1062,1079,17
F5wtY4Ns4nA,tying,suturing,1080,1095,15
wiT6R0xxh7w,cutting,cutting,24,44,20
wiT6R0xxh7w,cutting,cutting,45,122,77
wiT6R0xxh7w,tying,tying,181,186,5
wiT6R0xxh7w,tying,tying,230,250,20
wiT6R0xxh7w,tying,tying,258,266,8
wiT6R0xxh7w,tying,tying,277,282,5
wiT6R0xxh7w,suturing,suturing,168,178,10
n6XWCpbmHtw,,cutting,90,92,2
n6XWCpbmHtw,,cutting,156,158,2
eQCNSx0P7LM,tying,tying,211,237,26
eQCNSx0P7LM,none,suturing,89,94,5
eQCNSx0P7LM,suturing,suturing,95,113,18
eQCNSx0P7LM,suturing,suturing,178,189,11
eQCNSx0P7LM,,suturing,202,206,4
synW6molzgA,cutting,cutting,20,26,6
synW6molzgA,cutting,cutting,109,121,12
synW6molzgA,cutting,cutting,146,176,30
synW6molzgA,cutting,cutting,180,207,27
synW6molzgA,cutting,cutting,300,320,20
synW6molzgA,cutting,cutting,330,353,23
synW6molzgA,tying,tying,515,525,10
OrK0k3sBOHY,cutting,cutting,69,225,156
OrK0k3sBOHY,cutting,cutting,349,363,14
AYt94DNtKXU,,cutting,2,7,5
AYt94DNtKXU,cutting,cutting,9,44,35
AYt94DNtKXU,cutting,cutting,56,68,12
AYt94DNtKXU,cutting,cutting,94,106,12
AYt94DNtKXU,cutting,cutting,138,184,46
AYt94DNtKXU,cutting,cutting,218,236,18
AYt94DNtKXU,cutting,cutting,242,260,18
AYt94DNtKXU,cutting,cutting,302,314,12
AYt94DNtKXU,cutting,cutting,320,420,100
AYt94DNtKXU,cutting,cutting,514,564,50
AYt94DNtKXU,tying,tying,432,444,12
AYt94DNtKXU,,suturing,429,432,3
AYt94DNtKXU,suturing,suturing,501,514,13
AYt94DNtKXU,suturing,suturing,576,599,23
ftkqy5JBuSM,,cutting,0,2,2
ftkqy5JBuSM,,cutting,14,15,1
ftkqy5JBuSM,tying,tying,248,254,6
ftkqy5JBuSM,tying,tying,280,288,8
ftkqy5JBuSM,suturing,suturing,218,223,5
ftkqy5JBuSM,,suturing,237,242,5
ftkqy5JBuSM,,suturing,263,267,4
ftkqy5JBuSM,,suturing,273,276,3
357DW8IYYt8,cutting,cutting,61,132,71
357DW8IYYt8,none,cutting,133,138,5
357DW8IYYt8,cutting,cutting,139,162,23
357DW8IYYt8,none,cutting,163,168,5
357DW8IYYt8,cutting,cutting,169,188,19
357DW8IYYt8,tying,tying,215,222,7
357DW8IYYt8,suturing,suturing,205,215,10
357DW8IYYt8,suturing,suturing,235,246,11
357DW8IYYt8,suturing,suturing,253,276,23
357DW8IYYt8,none,suturing,277,282,5
357DW8IYYt8,tying,suturing,283,288,5
357DW8IYYt8,suturing,suturing,289,306,17
357DW8IYYt8,tying,suturing,307,318,11
357DW8IYYt8,suturing,suturing,319,354,35
357DW8IYYt8,tying,suturing,355,362,7
wVszq_SYrAQ,cutting,cutting,110,137,27
wVszq_SYrAQ,cutting,cutting,168,179,11
wVszq_SYrAQ,,cutting,198,202,4
wVszq_SYrAQ,cutting,cutting,211,262,51
wVszq_SYrAQ,cutting,cutting,262,270,8
wVszq_SYrAQ,cutting,cutting,290,322,32
wVszq_SYrAQ,cutting,cutting,322,327,5
wVszq_SYrAQ,cutting,cutting,346,390,44
NsXz7b--hC4,cutting,cutting,6,38,32
NsXz7b--hC4,cutting,cutting,42,50,8
NsXz7b--hC4,cutting,cutting,63,74,11
NsXz7b--hC4,,cutting,111,115,4
NsXz7b--hC4,cutting,cutting,145,155,10
NsXz7b--hC4,cutting,cutting,219,233,14
Fk5WjTJdVUA,cutting,cutting,14,25,11
Fk5WjTJdVUA,none,cutting,26,31,5
Fk5WjTJdVUA,cutting,cutting,32,54,22
oD5gC2ESBnk,cutting,cutting,9,93,84
oD5gC2ESBnk,cutting,cutting,98,109,11
oD5gC2ESBnk,cutting,cutting,608,634,26
oD5gC2ESBnk,cutting,cutting,675,704,29
oD5gC2ESBnk,cutting,cutting,729,755,26
oD5gC2ESBnk,cutting,cutting,800,823,23
bbI9l7j-LP4,,cutting,7,52,45
LmkAisEsaew,cutting,cutting,76,160,84
LmkAisEsaew,tying,tying,297,304,7
LmkAisEsaew,suturing,suturing,16,24,8
LmkAisEsaew,suturing,suturing,288,295,7
dLap-hcBxc0,,cutting,69,70,1
dLap-hcBxc0,cutting,cutting,71,79,8
N32N6VEcW2I,cutting,cutting,33,59,26
N32N6VEcW2I,cutting,cutting,74,89,15
N32N6VEcW2I,cutting,cutting,91,151,60
N32N6VEcW2I,cutting,cutting,180,186,6
N32N6VEcW2I,cutting,cutting,191,196,5
N32N6VEcW2I,cutting,cutting,213,220,7
N32N6VEcW2I,,cutting,255,260,5
N32N6VEcW2I,cutting,cutting,261,268,7
N32N6VEcW2I,cutting,cutting,337,356,19
N32N6VEcW2I,suturing,suturing,366,394,28
N32N6VEcW2I,suturing,suturing,467,478,11
N32N6VEcW2I,tying,suturing,479,496,17
N32N6VEcW2I,suturing,suturing,508,521,13
N32N6VEcW2I,suturing,suturing,527,535,8
N32N6VEcW2I,suturing,suturing,545,557,12
N6Er2hAGB3Y,,cutting,20,26,6
N6Er2hAGB3Y,,cutting,27,43,16
N6Er2hAGB3Y,,cutting,49,54,5
N6Er2hAGB3Y,,cutting,70,78,8
N6Er2hAGB3Y,,cutting,80,98,18
N6Er2hAGB3Y,,cutting,325,330,5
OZ9FXumhwFM,cutting,cutting,14,157,143
OZ9FXumhwFM,none,cutting,158,163,5
OZ9FXumhwFM,cutting,cutting,164,229,65
OZ9FXumhwFM,none,cutting,236,241,5
OZ9FXumhwFM,cutting,cutting,242,253,11
OZ9FXumhwFM,cutting,cutting,260,277,17
OZ9FXumhwFM,cutting,cutting,299,308,9
ycYdlwoKtEw,tying,tying,58,70,12
ycYdlwoKtEw,suturing,suturing,45,51,6
kQTmL3C2dwE,cutting,cutting,4,309,305
kQTmL3C2dwE,cutting,cutting,357,403,46
eko_xMEYTKw,,cutting,83,88,5
eko_xMEYTKw,,cutting,91,95,4
eko_xMEYTKw,cutting,cutting,106,116,10
eko_xMEYTKw,cutting,cutting,132,183,51
eko_xMEYTKw,cutting,cutting,190,198,8
eko_xMEYTKw,cutting,cutting,204,210,6
eko_xMEYTKw,cutting,cutting,217,224,7
eko_xMEYTKw,,cutting,244,249,5
eko_xMEYTKw,cutting,cutting,258,273,15
eko_xMEYTKw,cutting,cutting,281,289,8
eko_xMEYTKw,,cutting,298,300,2
eko_xMEYTKw,cutting,cutting,333,340,7
eko_xMEYTKw,cutting,cutting,364,370,6
eko_xMEYTKw,cutting,cutting,395,404,9
eko_xMEYTKw,cutting,cutting,483,490,7
eko_xMEYTKw,cutting,cutting,527,536,9
eko_xMEYTKw,,tying,539,544,5
eko_xMEYTKw,,tying,545,550,5
eko_xMEYTKw,suturing,suturing,552,562,10
hQGTpK3CbpE,cutting,cutting,51,57,6
hQGTpK3CbpE,suturing,suturing,407,427,20
UyTv72j6Lno,,cutting,69,74,5
V_kW8dMjGX0,,cutting,29,30,1
V_kW8dMjGX0,tying,tying,127,139,12
V_kW8dMjGX0,tying,tying,156,162,6
V_kW8dMjGX0,suturing,suturing,145,154,9
cpgMJ7KOVl8,cutting,cutting,0,136,136
cpgMJ7KOVl8,cutting,cutting,181,365,184
cpgMJ7KOVl8,cutting,suturing,365,374,9
d4-VN5A6_Ac,,cutting,8,10,2
d4-VN5A6_Ac,cutting,cutting,13,23,10
d4-VN5A6_Ac,cutting,cutting,64,77,13
d4-VN5A6_Ac,,cutting,106,110,4
d4-VN5A6_Ac,,tying,237,242,5
d4-VN5A6_Ac,suturing,suturing,137,147,10
d4-VN5A6_Ac,suturing,suturing,170,181,11
d4-VN5A6_Ac,,suturing,221,226,5
XoGw0yrEv4E,cutting,cutting,477,495,18
XoGw0yrEv4E,tying,tying,780,790,10
XoGw0yrEv4E,tying,tying,850,870,20
XoGw0yrEv4E,suturing,suturing,528,557,29
XoGw0yrEv4E,suturing,suturing,792,797,5
XoGw0yrEv4E,suturing,suturing,872,877,5
XoGw0yrEv4E,tying,suturing,878,885,7
Nqyq0uaEBOg,,cutting,6,14,8
Nqyq0uaEBOg,,cutting,18,30,12
Nqyq0uaEBOg,,cutting,34,42,8
Nqyq0uaEBOg,,cutting,46,55,9
Nqyq0uaEBOg,,tying,111,116,5
Nqyq0uaEBOg,,tying,130,138,8
Nqyq0uaEBOg,,tying,152,172,20
Nqyq0uaEBOg,,suturing,76,109,33
Nqyq0uaEBOg,,suturing,123,129,6
wZTMcbt85J4,cutting,cutting,10,126,116
wZTMcbt85J4,,cutting,382,387,5
Mp2m1AMx8Ks,cutting,cutting,15,28,13
Mp2m1AMx8Ks,cutting,cutting,40,66,26
Mp2m1AMx8Ks,tying,tying,103,130,27
Mp2m1AMx8Ks,suturing,suturing,77,90,13
Mp2m1AMx8Ks,,suturing,132,134,2
c7zxUjQSusQ,cutting,cutting,47,53,6
c7zxUjQSusQ,,cutting,61,64,3
c7zxUjQSusQ,tying,tying,152,165,13
c7zxUjQSusQ,tying,tying,269,276,7
c7zxUjQSusQ,tying,tying,322,332,10
c7zxUjQSusQ,tying,tying,348,354,6
c7zxUjQSusQ,tying,tying,367,374,7
c7zxUjQSusQ,tying,tying,397,405,8
c7zxUjQSusQ,tying,tying,443,448,5
c7zxUjQSusQ,,suturing,263,268,5
c7zxUjQSusQ,suturing,suturing,278,321,43
c7zxUjQSusQ,suturing,suturing,340,347,7
c7zxUjQSusQ,suturing,suturing,360,366,6
c7zxUjQSusQ,suturing,suturing,379,390,11
c7zxUjQSusQ,suturing,suturing,422,442,20
c7zxUjQSusQ,suturing,suturing,460,466,6
8cT4CV1gkAA,,cutting,467,472,5
ZwdbtYzY_6s,cutting,cutting,38,50,12
ZwdbtYzY_6s,cutting,cutting,54,89,35
ZwdbtYzY_6s,cutting,cutting,123,175,52
ZwdbtYzY_6s,tying,tying,197,203,6
ZwdbtYzY_6s,tying,tying,230,237,7
ZwdbtYzY_6s,,tying,268,272,4
ZwdbtYzY_6s,tying,tying,273,280,7
ZwdbtYzY_6s,tying,tying,287,292,5
ZwdbtYzY_6s,tying,tying,328,338,10
ZwdbtYzY_6s,suturing,suturing,177,188,11
ZwdbtYzY_6s,suturing,suturing,213,225,12
ZwdbtYzY_6s,suturing,suturing,238,261,23
ZwdbtYzY_6s,,suturing,281,286,5
ZwdbtYzY_6s,suturing,suturing,299,326,27
wBADkB_PFkA,,cutting,5,7,2
wBADkB_PFkA,,cutting,55,64,9
OsvR-ZxJtC0,,cutting,7,12,5
OsvR-ZxJtC0,cutting,cutting,37,51,14
OsvR-ZxJtC0,cutting,cutting,72,89,17
OsvR-ZxJtC0,suturing,suturing,52,70,18
onVsHOnSypQ,cutting,cutting,14,50,36
onVsHOnSypQ,tying,tying,282,297,15
onVsHOnSypQ,tying,tying,342,351,9
onVsHOnSypQ,tying,tying,390,396,6
onVsHOnSypQ,suturing,suturing,90,119,29
onVsHOnSypQ,suturing,suturing,141,200,59
onVsHOnSypQ,suturing,suturing,223,273,50
onVsHOnSypQ,suturing,suturing,312,335,23
onVsHOnSypQ,suturing,suturing,353,389,36
T5sNqOFwTfQ,cutting,cutting,3,32,29
T5sNqOFwTfQ,cutting,cutting,48,118,70
T5sNqOFwTfQ,cutting,cutting,131,166,35
T5sNqOFwTfQ,,cutting,184,187,3
T5sNqOFwTfQ,cutting,cutting,200,291,91
T5sNqOFwTfQ,cutting,cutting,304,312,8
T5sNqOFwTfQ,cutting,cutting,327,380,53
T5sNqOFwTfQ,tying,cutting,381,386,5
T5sNqOFwTfQ,cutting,cutting,387,513,126
WDLZ-G0IRJQ,cutting,cutting,19,106,87
WDLZ-G0IRJQ,,tying,183,187,4
WDLZ-G0IRJQ,suturing,suturing,106,123,17
WDLZ-G0IRJQ,tying,suturing,124,129,5
WDLZ-G0IRJQ,suturing,suturing,130,182,52
WDLZ-G0IRJQ,suturing,suturing,203,222,19
8VPsnDDEN04,cutting,cutting,27,58,31
8VPsnDDEN04,cutting,cutting,62,90,28
8VPsnDDEN04,cutting,cutting,100,134,34
8VPsnDDEN04,cutting,cutting,312,330,18
8VPsnDDEN04,tying,tying,364,383,19
8VPsnDDEN04,tying,tying,402,416,14
8VPsnDDEN04,suturing,suturing,169,184,15
8VPsnDDEN04,suturing,suturing,337,342,5
8VPsnDDEN04,none,suturing,343,348,5
8VPsnDDEN04,suturing,suturing,349,363,14
8VPsnDDEN04,suturing,suturing,390,400,10
x98rpVdG96Y,suturing,suturing,93,130,37
x98rpVdG96Y,suturing,suturing,140,156,16
Epicflt4WBQ,,tying,208,210,2
Epicflt4WBQ,,suturing,203,207,4
Epicflt4WBQ,,suturing,221,226,5
UyB951vsUfA,cutting,cutting,378,402,24
UyB951vsUfA,cutting,cutting,413,443,30
UyB951vsUfA,cutting,cutting,445,481,36
UyB951vsUfA,cutting,cutting,487,507,20
UyB951vsUfA,cutting,cutting,509,517,8
UyB951vsUfA,tying,tying,897,910,13
UyB951vsUfA,tying,tying,960,981,21
UyB951vsUfA,tying,tying,1011,1016,5
UyB951vsUfA,tying,tying,1047,1057,10
UyB951vsUfA,tying,tying,1100,1112,12
UyB951vsUfA,tying,tying,1248,1258,10
UyB951vsUfA,tying,tying,1264,1274,10
UyB951vsUfA,suturing,suturing,866,896,30
UyB951vsUfA,suturing,suturing,919,959,40
UyB951vsUfA,suturing,suturing,989,1010,21
UyB951vsUfA,suturing,suturing,1026,1046,20
UyB951vsUfA,suturing,suturing,1079,1099,20
UyB951vsUfA,suturing,suturing,1130,1247,117
rtJzPBn6FWw,cutting,cutting,17,25,8
rtJzPBn6FWw,tying,tying,115,123,8
rtJzPBn6FWw,suturing,suturing,108,115,7
rtJzPBn6FWw,,suturing,135,138,3
rtJzPBn6FWw,,suturing,150,155,5
rtJzPBn6FWw,suturing,suturing,167,177,10
rtJzPBn6FWw,,suturing,198,200,2
isyztOzq1Uw,,cutting,147,152,5
isyztOzq1Uw,,cutting,226,229,3
isyztOzq1Uw,,cutting,233,235,2
isyztOzq1Uw,cutting,cutting,237,253,16
isyztOzq1Uw,suturing,suturing,293,300,7
isyztOzq1Uw,suturing,suturing,313,324,11
OXlUtv2DIzY,cutting,cutting,119,137,18
OXlUtv2DIzY,cutting,cutting,292,343,51
OXlUtv2DIzY,cutting,cutting,366,375,9
OXlUtv2DIzY,cutting,cutting,380,418,38
OXlUtv2DIzY,,cutting,514,518,4
OXlUtv2DIzY,cutting,cutting,552,558,6
OXlUtv2DIzY,,cutting,564,569,5
OXlUtv2DIzY,cutting,tying,208,213,5
OXlUtv2DIzY,tying,tying,237,246,9
OXlUtv2DIzY,tying,tying,253,280,27
OXlUtv2DIzY,tying,tying,487,495,8
OXlUtv2DIzY,cutting,tying,607,614,7
OXlUtv2DIzY,tying,tying,623,636,13
OXlUtv2DIzY,tying,tying,641,654,13
OXlUtv2DIzY,,tying,664,667,3
OXlUtv2DIzY,tying,tying,691,696,5
OXlUtv2DIzY,tying,tying,715,724,9
OXlUtv2DIzY,,tying,729,732,3
OXlUtv2DIzY,tying,tying,737,747,10
OXlUtv2DIzY,tying,tying,752,759,7
OXlUtv2DIzY,suturing,suturing,185,207,22
OXlUtv2DIzY,suturing,suturing,220,236,16
OXlUtv2DIzY,,suturing,247,252,5
OXlUtv2DIzY,suturing,suturing,472,486,14
OXlUtv2DIzY,,suturing,502,506,4
OXlUtv2DIzY,,suturing,537,542,5
OXlUtv2DIzY,,suturing,619,622,3
OXlUtv2DIzY,,suturing,637,640,3
OXlUtv2DIzY,suturing,suturing,655,663,8
OXlUtv2DIzY,suturing,suturing,679,684,5
OXlUtv2DIzY,suturing,suturing,703,708,5
OXlUtv2DIzY,,suturing,725,728,3
OXlUtv2DIzY,,suturing,733,736,3
OXlUtv2DIzY,,suturing,748,751,3
8EhXEAp-uLI,,cutting,188,229,41
8EhXEAp-uLI,,cutting,236,243,7
8EhXEAp-uLI,,cutting,275,283,8
8EhXEAp-uLI,,cutting,294,309,15
8EhXEAp-uLI,,suturing,369,376,7
8EhXEAp-uLI,,suturing,388,394,6
AjwzlmTvT8A,cutting,cutting,8,13,5
AjwzlmTvT8A,cutting,cutting,25,75,50
bgWCyjuumn0,cutting,cutting,8,29,21
5NWSWNFboIY,cutting,cutting,209,360,151
EgVI5o-fS6o,abstain,cutting,0,54,54
AK8N5NoWlAI,cutting,cutting,82,91,9
AK8N5NoWlAI,cutting,cutting,100,126,26
AK8N5NoWlAI,cutting,cutting,134,139,5
AK8N5NoWlAI,cutting,cutting,169,174,5
AK8N5NoWlAI,cutting,cutting,322,340,18
AK8N5NoWlAI,cutting,cutting,346,355,9
AK8N5NoWlAI,cutting,cutting,475,505,30
AK8N5NoWlAI,tying,tying,1198,1205,7
AK8N5NoWlAI,suturing,suturing,1152,1194,42
iM5tFoqLX6Q,cutting,cutting,49,58,9
iM5tFoqLX6Q,,tying,95,100,5
sayim_KU_8c,cutting,cutting,179,203,24
VsKw5d-4rq8,cutting,cutting,169,214,45
VsKw5d-4rq8,tying,tying,1091,1101,10
WJ2jS88EUmo,cutting,cutting,37,88,51
WJ2jS88EUmo,cutting,cutting,99,126,27
WJ2jS88EUmo,cutting,cutting,240,260,20
WJ2jS88EUmo,cutting,cutting,300,310,10
WJ2jS88EUmo,cutting,cutting,344,350,6
WJ2jS88EUmo,cutting,cutting,361,369,8
WJ2jS88EUmo,cutting,cutting,380,388,8
WJ2jS88EUmo,tying,tying,221,227,6
WJ2jS88EUmo,tying,tying,421,436,15
WJ2jS88EUmo,tying,tying,493,500,7
WJ2jS88EUmo,tying,tying,513,520,7
WJ2jS88EUmo,tying,tying,529,537,8
WJ2jS88EUmo,suturing,suturing,89,98,9
WJ2jS88EUmo,suturing,suturing,484,492,8
WJ2jS88EUmo,suturing,suturing,503,512,9
WJ2jS88EUmo,suturing,suturing,521,528,7
zyW8m35aEr0,cutting,cutting,40,47,7
bM0gMFbQJ-E,cutting,cutting,57,110,53
bM0gMFbQJ-E,cutting,cutting,136,160,24
bM0gMFbQJ-E,tying,tying,208,226,18
bM0gMFbQJ-E,tying,tying,238,254,16
bM0gMFbQJ-E,tying,tying,273,288,15
bM0gMFbQJ-E,tying,tying,297,302,5
bM0gMFbQJ-E,tying,tying,322,335,13
bM0gMFbQJ-E,tying,tying,346,358,12
bM0gMFbQJ-E,tying,tying,370,384,14
bM0gMFbQJ-E,tying,tying,397,410,13
bM0gMFbQJ-E,tying,tying,425,435,10
bM0gMFbQJ-E,tying,tying,443,454,11
bM0gMFbQJ-E,tying,tying,467,485,18
bM0gMFbQJ-E,tying,tying,496,512,16
bM0gMFbQJ-E,tying,tying,514,532,18
bM0gMFbQJ-E,tying,tying,536,552,16
bM0gMFbQJ-E,tying,tying,557,568,11
bM0gMFbQJ-E,,suturing,230,235,5
bM0gMFbQJ-E,suturing,suturing,257,270,13
bM0gMFbQJ-E,,suturing,291,295,4
bM0gMFbQJ-E,suturing,suturing,311,318,7
bM0gMFbQJ-E,suturing,suturing,338,344,6
bM0gMFbQJ-E,suturing,suturing,362,369,7
bM0gMFbQJ-E,suturing,suturing,386,394,8
bM0gMFbQJ-E,suturing,suturing,412,417,5
bM0gMFbQJ-E,,suturing,437,440,3
bM0gMFbQJ-E,,suturing,461,464,3
bM0gMFbQJ-E,suturing,suturing,487,493,6
HP8pRJsWlGk,,cutting,108,122,14
HP8pRJsWlGk,,cutting,129,137,8
HP8pRJsWlGk,,suturing,79,84,5
HP8pRJsWlGk,,suturing,630,639,9
HP8pRJsWlGk,,suturing,657,667,10
HP8pRJsWlGk,,suturing,685,691,6
VyN4c_wsZuY,cutting,cutting,6,47,41
VyN4c_wsZuY,cutting,cutting,60,75,15
VyN4c_wsZuY,cutting,cutting,149,168,19
VyN4c_wsZuY,,cutting,185,190,5
VtJtGtC3R80,,cutting,46,66,20
RDpE1Q9Bkno,,cutting,16,31,15
RDpE1Q9Bkno,,tying,221,233,12
RDpE1Q9Bkno,,tying,246,257,11
RDpE1Q9Bkno,,tying,265,280,15
RDpE1Q9Bkno,,tying,303,325,22
RDpE1Q9Bkno,,tying,345,355,10
RDpE1Q9Bkno,,suturing,142,153,11
RDpE1Q9Bkno,,suturing,156,166,10
RDpE1Q9Bkno,,suturing,210,220,10
RDpE1Q9Bkno,,suturing,237,247,10
RDpE1Q9Bkno,,suturing,294,302,8
RDpE1Q9Bkno,,suturing,336,344,8
fHZ_0htxQ4k,cutting,cutting,190,289,99
fHZ_0htxQ4k,cutting,cutting,755,767,12
fHZ_0htxQ4k,cutting,cutting,824,829,5
fHZ_0htxQ4k,cutting,cutting,843,850,7
fHZ_0htxQ4k,cutting,cutting,880,898,18
fHZ_0htxQ4k,tying,tying,785,795,10
PqGpbc330j8,cutting,cutting,18,62,44
PqGpbc330j8,tying,suturing,62,67,5
PqGpbc330j8,suturing,suturing,68,75,7
1dki4N24iP8,cutting,cutting,17,24,7
1dki4N24iP8,cutting,cutting,28,37,9
1dki4N24iP8,cutting,cutting,47,153,106
1dki4N24iP8,cutting,cutting,157,408,251
1dki4N24iP8,none,cutting,409,414,5
1dki4N24iP8,cutting,cutting,415,594,179
1dki4N24iP8,none,cutting,595,600,5
1dki4N24iP8,cutting,cutting,601,679,78
Dqk7k7pnlVM,,cutting,20,22,2
Dqk7k7pnlVM,,cutting,27,30,3
Dqk7k7pnlVM,cutting,cutting,37,55,18
Dqk7k7pnlVM,,cutting,59,64,5
Dqk7k7pnlVM,cutting,cutting,66,80,14
Dqk7k7pnlVM,cutting,cutting,93,98,5
Dqk7k7pnlVM,cutting,cutting,106,122,16
Dqk7k7pnlVM,cutting,cutting,154,180,26
Dqk7k7pnlVM,cutting,cutting,183,189,6
Dqk7k7pnlVM,cutting,cutting,344,356,12
PCyfP8I87AI,cutting,cutting,86,126,40
PCyfP8I87AI,cutting,cutting,199,212,13
PCyfP8I87AI,,cutting,294,299,5
PCyfP8I87AI,cutting,cutting,507,550,43
PCyfP8I87AI,cutting,cutting,576,588,12
PCyfP8I87AI,,tying,658,662,4
PCyfP8I87AI,suturing,suturing,674,687,13
PCyfP8I87AI,tying,suturing,693,701,8
PCyfP8I87AI,,suturing,718,723,5
IqpcBRQMOak,cutting,cutting,24,51,27
IqpcBRQMOak,cutting,cutting,64,97,33
IqpcBRQMOak,cutting,cutting,170,185,15
IqpcBRQMOak,cutting,cutting,212,225,13
IqpcBRQMOak,cutting,cutting,262,280,18
rmcomZXiud4,cutting,cutting,6,16,10
rmcomZXiud4,cutting,cutting,60,98,38
ou4iO5ah9ys,cutting,cutting,71,76,5
ou4iO5ah9ys,cutting,cutting,173,185,12
T03GIXho9mY,cutting,cutting,41,106,65
T03GIXho9mY,cutting,cutting,115,123,8
T03GIXho9mY,cutting,cutting,131,139,8
T03GIXho9mY,cutting,cutting,180,195,15
T03GIXho9mY,cutting,cutting,202,233,31
T03GIXho9mY,suturing,suturing,140,177,37
T03GIXho9mY,suturing,suturing,249,260,11
8bhWGpkmWp8,cutting,cutting,1,72,71
8bhWGpkmWp8,none,cutting,73,78,5
8bhWGpkmWp8,cutting,cutting,79,85,6
8bhWGpkmWp8,cutting,cutting,113,129,16
8bhWGpkmWp8,,cutting,145,147,2
s0z0WYcC7dA,,cutting,181,184,3
s0z0WYcC7dA,,cutting,186,188,2
s0z0WYcC7dA,cutting,cutting,223,230,7
s0z0WYcC7dA,cutting,cutting,262,269,7
s0z0WYcC7dA,,cutting,295,296,1
s0z0WYcC7dA,cutting,cutting,320,336,16
s0z0WYcC7dA,cutting,cutting,367,374,7
s0z0WYcC7dA,cutting,cutting,384,392,8
s0z0WYcC7dA,cutting,cutting,417,438,21
s0z0WYcC7dA,cutting,cutting,440,448,8
s0z0WYcC7dA,,cutting,453,455,2
s0z0WYcC7dA,cutting,cutting,457,474,17
s0z0WYcC7dA,cutting,cutting,507,525,18
s0z0WYcC7dA,cutting,cutting,537,549,12
s0z0WYcC7dA,,cutting,566,570,4
s0z0WYcC7dA,cutting,cutting,759,788,29
s0z0WYcC7dA,,cutting,799,803,4
s0z0WYcC7dA,,cutting,833,835,2
s0z0WYcC7dA,cutting,cutting,879,884,5
s0z0WYcC7dA,cutting,cutting,894,899,5
s0z0WYcC7dA,cutting,cutting,913,927,14
s0z0WYcC7dA,suturing,cutting,948,968,20
s0z0WYcC7dA,tying,tying,661,670,9
s0z0WYcC7dA,tying,tying,677,689,12
s0z0WYcC7dA,tying,tying,720,729,9
s0z0WYcC7dA,tying,tying,970,978,8
s0z0WYcC7dA,tying,tying,980,986,6
s0z0WYcC7dA,suturing,suturing,653,659,6
s0z0WYcC7dA,suturing,suturing,707,719,12
Z4Z03ebdSa8,cutting,cutting,150,189,39
Z4Z03ebdSa8,cutting,cutting,197,202,5
Z4Z03ebdSa8,cutting,cutting,390,398,8
Z4Z03ebdSa8,,cutting,409,413,4
WTO1F3NG8PE,cutting,cutting,111,124,13
WTO1F3NG8PE,cutting,cutting,132,148,16
WTO1F3NG8PE,cutting,cutting,159,164,5
WTO1F3NG8PE,,cutting,184,189,5
WTO1F3NG8PE,cutting,cutting,192,200,8
WTO1F3NG8PE,cutting,cutting,209,214,5
WTO1F3NG8PE,cutting,cutting,230,235,5
WTO1F3NG8PE,cutting,cutting,262,269,7
WTO1F3NG8PE,cutting,cutting,283,289,6
WTO1F3NG8PE,cutting,cutting,319,324,5
WTO1F3NG8PE,cutting,cutting,334,386,52
WTO1F3NG8PE,cutting,cutting,395,405,10
WTO1F3NG8PE,cutting,cutting,428,435,7
WTO1F3NG8PE,cutting,cutting,536,541,5
WTO1F3NG8PE,,cutting,562,565,3
WTO1F3NG8PE,cutting,cutting,573,582,9
WTO1F3NG8PE,cutting,cutting,584,591,7
WTO1F3NG8PE,cutting,cutting,604,610,6
NL72fNR2hSM,cutting,cutting,87,134,47
NL72fNR2hSM,cutting,cutting,205,232,27
pbkOtT3Q2AM,cutting,cutting,72,160,88
pbkOtT3Q2AM,cutting,cutting,169,199,30
pbkOtT3Q2AM,cutting,cutting,211,221,10
pbkOtT3Q2AM,cutting,cutting,229,239,10
pbkOtT3Q2AM,cutting,cutting,259,285,26
pbkOtT3Q2AM,cutting,cutting,293,313,20
pbkOtT3Q2AM,tying,tying,325,341,16
pbkOtT3Q2AM,tying,tying,391,396,5
pbkOtT3Q2AM,tying,tying,405,417,12
pbkOtT3Q2AM,tying,tying,441,453,12
pbkOtT3Q2AM,tying,tying,491,504,13
pbkOtT3Q2AM,tying,tying,528,552,24
pbkOtT3Q2AM,suturing,suturing,248,257,9
pbkOtT3Q2AM,suturing,suturing,314,322,8
pbkOtT3Q2AM,suturing,suturing,354,374,20
pbkOtT3Q2AM,suturing,suturing,377,390,13
pbkOtT3Q2AM,suturing,suturing,423,434,11
pbkOtT3Q2AM,suturing,suturing,475,490,15
pbkOtT3Q2AM,suturing,suturing,508,527,19
pbkOtT3Q2AM,suturing,suturing,577,583,6
6idNh90AdtA,,cutting,147,152,5
6idNh90AdtA,cutting,cutting,167,186,19
6idNh90AdtA,,cutting,307,312,5
6idNh90AdtA,,cutting,316,318,2
6idNh90AdtA,cutting,cutting,378,389,11
6idNh90AdtA,cutting,cutting,399,410,11
6idNh90AdtA,,cutting,449,453,4
6idNh90AdtA,tying,tying,510,519,9
6idNh90AdtA,suturing,suturing,239,245,6
6idNh90AdtA,,suturing,247,251,4
6idNh90AdtA,,suturing,261,264,3
6idNh90AdtA,suturing,suturing,330,338,8
6idNh90AdtA,suturing,suturing,503,509,6
V7vkRKaUkn8,,cutting,261,297,36
V7vkRKaUkn8,,cutting,324,330,6
V7vkRKaUkn8,,cutting,333,359,26
V7vkRKaUkn8,,cutting,414,434,20
V7vkRKaUkn8,,tying,623,629,6
V7vkRKaUkn8,,suturing,367,372,5
Vnab8vZQcK8,,cutting,130,134,4
Vnab8vZQcK8,cutting,cutting,140,147,7
ZP58Wx0QaWE,cutting,cutting,11,60,49
ZP58Wx0QaWE,cutting,cutting,85,107,22
ZP58Wx0QaWE,,cutting,125,128,3
KV1bU0Kl9Fc,cutting,cutting,13,19,6
KV1bU0Kl9Fc,tying,cutting,35,43,8
KV1bU0Kl9Fc,cutting,cutting,265,289,24
KV1bU0Kl9Fc,cutting,cutting,329,334,5
KV1bU0Kl9Fc,cutting,cutting,392,405,13
KV1bU0Kl9Fc,cutting,cutting,653,663,10
KV1bU0Kl9Fc,,cutting,784,789,5
KV1bU0Kl9Fc,cutting,cutting,795,803,8
KV1bU0Kl9Fc,,cutting,996,999,3
KV1bU0Kl9Fc,cutting,cutting,1126,1135,9
KV1bU0Kl9Fc,cutting,cutting,1192,1205,13
OsYDOBpXC48,,cutting,40,48,8
OsYDOBpXC48,,cutting,90,98,8
OsYDOBpXC48,,cutting,121,132,11
OsYDOBpXC48,,cutting,135,143,8
OsYDOBpXC48,,cutting,163,188,25
OsYDOBpXC48,,cutting,197,200,3
OsYDOBpXC48,,tying,287,294,7
OsYDOBpXC48,,suturing,284,285,1
OsYDOBpXC48,,suturing,311,323,12
panFAJHLz_Q,cutting,cutting,21,49,28
panFAJHLz_Q,cutting,cutting,56,70,14
panFAJHLz_Q,cutting,cutting,89,108,19
panFAJHLz_Q,cutting,cutting,131,137,6
panFAJHLz_Q,cutting,cutting,143,151,8
panFAJHLz_Q,cutting,cutting,214,229,15
panFAJHLz_Q,,cutting,260,265,5
panFAJHLz_Q,cutting,cutting,292,301,9
panFAJHLz_Q,cutting,tying,655,663,8
panFAJHLz_Q,tying,tying,769,775,6
panFAJHLz_Q,suturing,suturing,591,634,43
panFAJHLz_Q,,suturing,764,767,3
panFAJHLz_Q,suturing,suturing,788,813,25
panFAJHLz_Q,suturing,suturing,837,863,26
panFAJHLz_Q,suturing,suturing,890,904,14
_35HaYVPBIA,cutting,cutting,89,98,9
FMLfc2V18HY,,cutting,65,70,5
FMLfc2V18HY,,suturing,410,419,9
JT_ec9IVCzI,tying,tying,2,11,9
JT_ec9IVCzI,tying,tying,25,30,5
XnkQgjOM5RU,cutting,cutting,152,175,23
XnkQgjOM5RU,cutting,cutting,260,285,25
axVfF8m0LCU,cutting,cutting,15,30,15
GJ5RwKonnms,,cutting,56,58,2
GJ5RwKonnms,cutting,cutting,111,130,19
GJ5RwKonnms,cutting,cutting,136,143,7
GJ5RwKonnms,cutting,cutting,158,203,45
GJ5RwKonnms,suturing,suturing,231,242,11
GJ5RwKonnms,tying,suturing,243,248,5
GJ5RwKonnms,cutting,suturing,249,254,5
GJ5RwKonnms,tying,suturing,255,262,7
vmJjIIt-wAY,cutting,cutting,233,290,57
vmJjIIt-wAY,,suturing,301,305,4
vmJjIIt-wAY,,suturing,310,314,4
vmJjIIt-wAY,,suturing,319,322,3
zNnwVj9whYA,cutting,cutting,7,24,17
zNnwVj9whYA,suturing,tying,55,60,5
zNnwVj9whYA,tying,tying,61,66,5
zNnwVj9whYA,tying,tying,75,93,18
zNnwVj9whYA,suturing,suturing,195,224,29
V3Fd-cRcdCA,cutting,cutting,12,47,35
V3Fd-cRcdCA,cutting,cutting,65,108,43
V3Fd-cRcdCA,cutting,cutting,124,136,12
V3Fd-cRcdCA,cutting,cutting,143,203,60
V3Fd-cRcdCA,cutting,cutting,214,236,22
V3Fd-cRcdCA,suturing,suturing,258,275,17
V3Fd-cRcdCA,tying,suturing,276,302,26
V3Fd-cRcdCA,suturing,suturing,303,326,23
V3Fd-cRcdCA,tying,suturing,327,343,16
sIr0IxtC7C4,,cutting,84,88,4
sIr0IxtC7C4,cutting,cutting,92,118,26
sIr0IxtC7C4,cutting,cutting,147,173,26
sIr0IxtC7C4,suturing,suturing,275,281,6
sIr0IxtC7C4,suturing,suturing,285,296,11
S4p9MmTfVTs,cutting,cutting,7,37,30
S4p9MmTfVTs,cutting,cutting,70,77,7
S4p9MmTfVTs,,cutting,374,377,3
S4p9MmTfVTs,tying,tying,253,265,12
S4p9MmTfVTs,tying,tying,287,297,10
S4p9MmTfVTs,tying,tying,322,337,15
S4p9MmTfVTs,tying,tying,350,356,6
S4p9MmTfVTs,,tying,360,364,4
S4p9MmTfVTs,tying,tying,430,436,6
S4p9MmTfVTs,suturing,suturing,240,253,13
S4p9MmTfVTs,suturing,suturing,280,287,7
S4p9MmTfVTs,suturing,suturing,312,322,10
S4p9MmTfVTs,,suturing,357,360,3
kHJh0MBx5Kc,,cutting,1,47,46
kHJh0MBx5Kc,,cutting,66,69,3
kHJh0MBx5Kc,,cutting,90,97,7
kHJh0MBx5Kc,,cutting,133,161,28
kHJh0MBx5Kc,,cutting,186,197,11
kHJh0MBx5Kc,,cutting,611,624,13
kHJh0MBx5Kc,,cutting,636,640,4
kHJh0MBx5Kc,,cutting,1008,1013,5
kHJh0MBx5Kc,,cutting,1318,1326,8
kHJh0MBx5Kc,,cutting,1647,1651,4
kHJh0MBx5Kc,,tying,1434,1443,9
kHJh0MBx5Kc,,tying,1675,1682,7
3Q5D4vdXOqc,cutting,cutting,262,273,11
3Q5D4vdXOqc,cutting,cutting,283,295,12
3Q5D4vdXOqc,cutting,cutting,304,314,10
3Q5D4vdXOqc,,cutting,319,320,1
3Q5D4vdXOqc,suturing,suturing,374,397,23
3Q5D4vdXOqc,tying,suturing,398,409,11
3Q5D4vdXOqc,suturing,suturing,410,427,17
3Q5D4vdXOqc,tying,suturing,428,438,10
3Q5D4vdXOqc,suturing,suturing,442,447,5
7Ku5P3nL8TA,cutting,cutting,33,204,171
7Ku5P3nL8TA,cutting,cutting,245,266,21
jkIGODwL228,cutting,suturing,210,215,5
jkIGODwL228,suturing,suturing,216,221,5
jkIGODwL228,tying,suturing,222,233,11
jkIGODwL228,suturing,suturing,234,245,11
jkIGODwL228,tying,suturing,246,251,5
jkIGODwL228,suturing,suturing,252,257,5
jkIGODwL228,tying,suturing,258,270,12
zRk7vi3FsyU,cutting,cutting,22,30,8
zRk7vi3FsyU,cutting,cutting,269,276,7
zRk7vi3FsyU,tying,suturing,349,366,17
zRk7vi3FsyU,suturing,suturing,367,390,23
zRk7vi3FsyU,tying,suturing,391,396,5
zRk7vi3FsyU,suturing,suturing,397,408,11
zRk7vi3FsyU,tying,suturing,409,414,5
zRk7vi3FsyU,suturing,suturing,415,426,11
zRk7vi3FsyU,tying,suturing,427,432,5
zRk7vi3FsyU,suturing,suturing,433,444,11
zRk7vi3FsyU,tying,suturing,445,450,5
zRk7vi3FsyU,none,suturing,451,456,5
zRk7vi3FsyU,suturing,suturing,457,468,11
zRk7vi3FsyU,tying,suturing,469,474,5
zRk7vi3FsyU,suturing,suturing,475,486,11
zRk7vi3FsyU,tying,suturing,487,510,23
zRk7vi3FsyU,suturing,suturing,511,540,29
zRk7vi3FsyU,tying,suturing,541,546,5
zRk7vi3FsyU,suturing,suturing,547,570,23
zRk7vi3FsyU,tying,suturing,571,576,5
zRk7vi3FsyU,suturing,suturing,577,588,11
zRk7vi3FsyU,tying,suturing,589,594,5
zRk7vi3FsyU,suturing,suturing,595,600,5
zRk7vi3FsyU,tying,suturing,601,619,18
zRk7vi3FsyU,suturing,suturing,660,665,5
zRk7vi3FsyU,tying,suturing,666,719,53
zRk7vi3FsyU,suturing,suturing,720,761,41
zRk7vi3FsyU,tying,suturing,762,767,5
zRk7vi3FsyU,none,suturing,768,773,5
zRk7vi3FsyU,suturing,suturing,774,785,11
zRk7vi3FsyU,none,suturing,786,791,5
zRk7vi3FsyU,suturing,suturing,792,803,11
zRk7vi3FsyU,tying,suturing,804,840,36
mDvZwgwQ2oc,cutting,cutting,20,40,20
mDvZwgwQ2oc,cutting,cutting,40,69,29
mDvZwgwQ2oc,tying,tying,110,120,10
lBmRC9LhFgw,cutting,cutting,163,190,27
lBmRC9LhFgw,tying,suturing,239,244,5
lBmRC9LhFgw,suturing,suturing,280,300,20
lBmRC9LhFgw,suturing,suturing,314,340,26
0VMxXsqmxYg,cutting,cutting,43,56,13
0VMxXsqmxYg,cutting,cutting,61,85,24
hE7HSiip4ZA,cutting,cutting,149,170,21
N8vXhfGUaHg,cutting,cutting,3,25,22
N8vXhfGUaHg,suturing,tying,105,110,5
N8vXhfGUaHg,,suturing,98,103,5
dKF78zABOQs,,cutting,37,39,2
dKF78zABOQs,,cutting,42,46,4
dKF78zABOQs,,cutting,51,54,3
dKF78zABOQs,,cutting,76,85,9
GT-FLlE95KU,cutting,cutting,180,265,85
GT-FLlE95KU,tying,tying,265,280,15
GT-FLlE95KU,none,suturing,690,695,5
GT-FLlE95KU,suturing,suturing,696,707,11
GT-FLlE95KU,tying,suturing,708,725,17
GT-FLlE95KU,suturing,suturing,726,791,65
GT-FLlE95KU,tying,suturing,792,797,5
GT-FLlE95KU,suturing,suturing,798,870,72
V6pL0fMsVn0,cutting,cutting,36,82,46
V6pL0fMsVn0,cutting,cutting,243,274,31
V6pL0fMsVn0,cutting,cutting,294,304,10
V6pL0fMsVn0,cutting,cutting,395,405,10
V6pL0fMsVn0,suturing,suturing,10,21,11
V6pL0fMsVn0,tying,suturing,22,34,12
V6pL0fMsVn0,tying,suturing,120,134,14
RWHBTwfa5C8,suturing,tying,310,316,6
RWHBTwfa5C8,suturing,suturing,303,310,7
RWHBTwfa5C8,suturing,suturing,327,333,6
giVy41llq00,cutting,cutting,10,40,30
giVy41llq00,suturing,suturing,49,60,11
giVy41llq00,tying,suturing,61,66,5
giVy41llq00,suturing,suturing,67,78,11
giVy41llq00,tying,suturing,79,84,5
giVy41llq00,suturing,suturing,85,90,5
giVy41llq00,tying,suturing,91,102,11
giVy41llq00,none,suturing,103,109,6
Nf5CArskkzM,cutting,cutting,46,97,51
Nf5CArskkzM,cutting,cutting,111,157,46
Nf5CArskkzM,cutting,cutting,171,182,11
Nf5CArskkzM,cutting,cutting,202,209,7
Nf5CArskkzM,cutting,cutting,218,243,25
Nf5CArskkzM,,suturing,433,437,4
Nf5CArskkzM,suturing,suturing,460,471,11
Nf5CArskkzM,tying,suturing,472,482,10
Rw5idx6VjbI,cutting,cutting,87,92,5
Rw5idx6VjbI,cutting,cutting,100,113,13
Rw5idx6VjbI,cutting,cutting,116,123,7
Rw5idx6VjbI,cutting,cutting,127,145,18
Rw5idx6VjbI,cutting,cutting,215,265,50
Rw5idx6VjbI,suturing,suturing,3,14,11
Rw5idx6VjbI,tying,suturing,15,20,5
Rw5idx6VjbI,suturing,suturing,21,68,47
Rw5idx6VjbI,tying,suturing,69,76,7
Rw5idx6VjbI,suturing,suturing,279,320,41
Rw5idx6VjbI,tying,suturing,321,326,5
Rw5idx6VjbI,suturing,suturing,327,374,47
Rw5idx6VjbI,tying,suturing,375,380,5
Rw5idx6VjbI,suturing,suturing,381,422,41
Rw5idx6VjbI,tying,suturing,423,429,6
YFs_AfPeK84,cutting,cutting,139,220,81
YFs_AfPeK84,tying,tying,275,295,20
SNsUtI82de8,cutting,cutting,60,100,40
SNsUtI82de8,cutting,cutting,110,120,10
njHyoJ_rKLs,cutting,cutting,58,133,75
njHyoJ_rKLs,tying,suturing,135,143,8
kipTlXQpPZw,cutting,cutting,92,121,29
aSnUUpTgYW0,abstain,cutting,0,7,7
aSnUUpTgYW0,,cutting,328,331,3
aSnUUpTgYW0,abstain,tying,295,319,24
aSnUUpTgYW0,abstain,suturing,408,510,102
aSnUUpTgYW0,abstain,suturing,523,599,76
MQ0w6hXABDc,abstain,cutting,120,132,12
dqVauLWgZ5k,abstain,cutting,62,89,27
dqVauLWgZ5k,,tying,140,144,4
dqVauLWgZ5k,,tying,148,151,3
dqVauLWgZ5k,cutting,suturing,98,103,5
dqVauLWgZ5k,tying,suturing,104,109,5
dqVauLWgZ5k,suturing,suturing,110,134,24
S1R95eOuSNk,cutting,cutting,67,91,24
S1R95eOuSNk,tying,tying,105,153,48
S1R95eOuSNk,tying,tying,197,230,33
S1R95eOuSNk,suturing,tying,250,261,11
S1R95eOuSNk,tying,tying,262,358,96
3Ql0fGVrQeA,cutting,cutting,98,118,20
3Ql0fGVrQeA,cutting,cutting,132,150,18
3Ql0fGVrQeA,cutting,cutting,198,210,12
3Ql0fGVrQeA,,tying,296,299,3
3Ql0fGVrQeA,suturing,suturing,235,263,28
3Ql0fGVrQeA,suturing,suturing,284,296,12
pwWamkMfIR0,cutting,cutting,5,17,12
pwWamkMfIR0,cutting,cutting,33,155,122
pwWamkMfIR0,cutting,cutting,170,195,25
pwWamkMfIR0,cutting,cutting,229,248,19
pwWamkMfIR0,tying,suturing,312,317,5
pwWamkMfIR0,suturing,suturing,318,347,29
pwWamkMfIR0,tying,suturing,348,359,11
pwWamkMfIR0,none,suturing,360,365,5
pwWamkMfIR0,tying,suturing,366,371,5
pwWamkMfIR0,none,suturing,372,377,5
pwWamkMfIR0,suturing,suturing,378,401,23
pwWamkMfIR0,none,suturing,402,407,5
pwWamkMfIR0,suturing,suturing,408,425,17
pwWamkMfIR0,tying,suturing,426,434,8
jogJdtFU8SY,cutting,cutting,44,66,22
jogJdtFU8SY,cutting,cutting,72,120,48
jogJdtFU8SY,cutting,cutting,128,170,42
jogJdtFU8SY,cutting,cutting,175,186,11
jogJdtFU8SY,cutting,cutting,193,275,82
jogJdtFU8SY,cutting,suturing,312,317,5
jogJdtFU8SY,cutting,suturing,330,337,7
jogJdtFU8SY,cutting,suturing,363,373,10
jogJdtFU8SY,suturing,suturing,434,443,9
Nqs73GAXAxs,,cutting,13,20,7
Nqs73GAXAxs,,tying,251,262,11
Nqs73GAXAxs,,tying,288,301,13
Nqs73GAXAxs,,tying,416,424,8
Nqs73GAXAxs,,tying,445,455,10
Nqs73GAXAxs,,tying,490,496,6
Nqs73GAXAxs,,tying,511,518,7
Nqs73GAXAxs,,tying,533,542,9
Nqs73GAXAxs,,tying,553,563,10
Nqs73GAXAxs,,tying,581,586,5
Nqs73GAXAxs,,tying,607,615,8
Nqs73GAXAxs,,tying,665,686,21
Nqs73GAXAxs,,tying,705,716,11
Nqs73GAXAxs,,tying,738,746,8
Nqs73GAXAxs,,suturing,407,415,8
Nqs73GAXAxs,,suturing,432,444,12
Nqs73GAXAxs,,suturing,483,489,6
Nqs73GAXAxs,,suturing,504,510,6
Nqs73GAXAxs,,suturing,527,532,5
Nqs73GAXAxs,,suturing,548,552,4
Nqs73GAXAxs,,suturing,573,580,7
Nqs73GAXAxs,,suturing,596,606,10
Nqs73GAXAxs,,suturing,655,664,9
Nqs73GAXAxs,,suturing,694,704,10
Nqs73GAXAxs,,suturing,727,737,10
zPP8sy1C6-4,tying,tying,200,210,10
zPP8sy1C6-4,tying,tying,530,570,40
zPP8sy1C6-4,tying,tying,690,700,10
zPP8sy1C6-4,tying,tying,720,725,5
zPP8sy1C6-4,suturing,tying,726,731,5
zPP8sy1C6-4,tying,tying,732,750,18
zPP8sy1C6-4,suturing,tying,770,780,10
zPP8sy1C6-4,tying,tying,800,810,10
zPP8sy1C6-4,tying,tying,920,930,10
zPP8sy1C6-4,suturing,suturing,600,629,29
zPP8sy1C6-4,tying,suturing,630,660,30
zPP8sy1C6-4,tying,suturing,700,711,11
zPP8sy1C6-4,suturing,suturing,712,720,8
zPP8sy1C6-4,suturing,suturing,790,800,10
zPP8sy1C6-4,none,suturing,810,815,5
zPP8sy1C6-4,suturing,suturing,816,833,17
zPP8sy1C6-4,tying,suturing,834,851,17
zPP8sy1C6-4,suturing,suturing,852,870,18
zPP8sy1C6-4,suturing,suturing,953,958,5
zPP8sy1C6-4,tying,suturing,959,982,23
zPP8sy1C6-4,suturing,suturing,983,1012,29
zPP8sy1C6-4,tying,suturing,1013,1020,7
l7Fd7vTBkjE,cutting,cutting,20,50,30
l7Fd7vTBkjE,cutting,cutting,64,74,10
l7Fd7vTBkjE,cutting,cutting,81,90,9
l7Fd7vTBkjE,cutting,cutting,612,634,22
l7Fd7vTBkjE,suturing,tying,802,807,5
l7Fd7vTBkjE,tying,tying,808,904,96
l7Fd7vTBkjE,suturing,suturing,970,1011,41
l7Fd7vTBkjE,tying,suturing,1012,1023,11
l7Fd7vTBkjE,suturing,suturing,1024,1041,17
l7Fd7vTBkjE,tying,suturing,1042,1047,5
l7Fd7vTBkjE,suturing,suturing,1048,1059,11
l7Fd7vTBkjE,tying,suturing,1060,1065,5
l7Fd7vTBkjE,suturing,suturing,1066,1077,11
l7Fd7vTBkjE,tying,suturing,1078,1083,5
l7Fd7vTBkjE,suturing,suturing,1084,1095,11
l7Fd7vTBkjE,tying,suturing,1096,1101,5
l7Fd7vTBkjE,suturing,suturing,1102,1113,11
l7Fd7vTBkjE,tying,suturing,1114,1127,13
l7Fd7vTBkjE,suturing,suturing,1180,1221,41
l7Fd7vTBkjE,tying,suturing,1222,1227,5
l7Fd7vTBkjE,suturing,suturing,1228,1233,5
l7Fd7vTBkjE,tying,suturing,1234,1239,5
l7Fd7vTBkjE,suturing,suturing,1240,1305,65
l7Fd7vTBkjE,tying,suturing,1306,1311,5
l7Fd7vTBkjE,suturing,suturing,1312,1323,11
l7Fd7vTBkjE,tying,suturing,1324,1329,5
l7Fd7vTBkjE,suturing,suturing,1330,1335,5
l7Fd7vTBkjE,tying,suturing,1336,1341,5
l7Fd7vTBkjE,suturing,suturing,1342,1353,11
l7Fd7vTBkjE,tying,suturing,1354,1369,15
hqeq7pZOTgY,tying,suturing,45,56,11
hqeq7pZOTgY,suturing,suturing,57,65,8
hqeq7pZOTgY,suturing,suturing,93,98,5
hqeq7pZOTgY,tying,suturing,99,104,5
hqeq7pZOTgY,suturing,suturing,105,115,10
hqeq7pZOTgY,tying,suturing,153,158,5
hqeq7pZOTgY,suturing,suturing,159,182,23
hqeq7pZOTgY,suturing,suturing,240,246,6
hqeq7pZOTgY,suturing,suturing,354,365,11
hqeq7pZOTgY,tying,suturing,366,377,11
hqeq7pZOTgY,suturing,suturing,378,445,67
XfnUomzjvfs,cutting,cutting,128,143,15
XfnUomzjvfs,cutting,cutting,563,570,7
XfnUomzjvfs,cutting,cutting,650,679,29
XfnUomzjvfs,none,cutting,680,685,5
XfnUomzjvfs,cutting,cutting,686,695,9
XfnUomzjvfs,suturing,suturing,945,950,5
XfnUomzjvfs,tying,suturing,951,956,5
XfnUomzjvfs,suturing,suturing,957,972,15
XfnUomzjvfs,suturing,suturing,1260,1300,40
h-Ma9JnznLc,,cutting,324,370,46
h-Ma9JnznLc,,cutting,386,400,14
h-Ma9JnznLc,,tying,654,658,4
h-Ma9JnznLc,,tying,669,679,10
h-Ma9JnznLc,,suturing,610,645,35
_lCgV4ZgAao,cutting,cutting,16,106,90
_lCgV4ZgAao,cutting,cutting,136,170,34
_lCgV4ZgAao,cutting,cutting,178,202,24
_lCgV4ZgAao,cutting,cutting,258,282,24
_lCgV4ZgAao,cutting,cutting,292,334,42
_lCgV4ZgAao,suturing,suturing,339,355,16
_lCgV4ZgAao,suturing,suturing,572,613,41
_lCgV4ZgAao,tying,suturing,614,631,17
_lCgV4ZgAao,none,suturing,632,637,5
_lCgV4ZgAao,suturing,suturing,638,685,47
_lCgV4ZgAao,tying,suturing,686,709,23
_lCgV4ZgAao,suturing,suturing,710,739,29
_lCgV4ZgAao,none,suturing,740,745,5
_lCgV4ZgAao,suturing,suturing,746,793,47
_lCgV4ZgAao,tying,suturing,794,805,11
_lCgV4ZgAao,suturing,suturing,806,815,9
LPriMk5xy20,,cutting,228,240,12
LPriMk5xy20,,cutting,243,245,2
LPriMk5xy20,,cutting,248,252,4
LPriMk5xy20,,cutting,257,261,4
LPriMk5xy20,,cutting,263,277,14
LPriMk5xy20,,cutting,283,284,1
LPriMk5xy20,,cutting,287,289,2
LPriMk5xy20,,cutting,292,296,4
LPriMk5xy20,,cutting,308,310,2
LPriMk5xy20,,cutting,314,315,1
LPriMk5xy20,,cutting,319,320,1
LPriMk5xy20,,cutting,322,323,1
LPriMk5xy20,,cutting,324,325,1
LPriMk5xy20,,cutting,329,330,1
LPriMk5xy20,,cutting,333,340,7
LPriMk5xy20,,cutting,363,365,2
LPriMk5xy20,,cutting,369,370,1
LPriMk5xy20,,cutting,373,375,2
LPriMk5xy20,,cutting,380,381,1
LPriMk5xy20,,cutting,382,383,1
LPriMk5xy20,,cutting,385,388,3
LPriMk5xy20,,cutting,392,394,2
LPriMk5xy20,,cutting,396,397,1
LPriMk5xy20,,cutting,399,401,2
LPriMk5xy20,,cutting,403,406,3
LPriMk5xy20,,cutting,408,410,2
LPriMk5xy20,,cutting,414,415,1
LPriMk5xy20,,cutting,425,426,1
LPriMk5xy20,,cutting,427,429,2
LPriMk5xy20,,cutting,432,433,1
LPriMk5xy20,,cutting,435,437,2
LPriMk5xy20,,cutting,440,443,3
LPriMk5xy20,,cutting,446,449,3
LPriMk5xy20,,cutting,506,523,17
LPriMk5xy20,,cutting,526,540,14
LPriMk5xy20,,cutting,555,579,24
LPriMk5xy20,,tying,776,786,10
LPriMk5xy20,,tying,793,808,15
LPriMk5xy20,,tying,811,817,6
LPriMk5xy20,,tying,828,835,7
LPriMk5xy20,,tying,842,849,7
LPriMk5xy20,,tying,878,888,10
LPriMk5xy20,,tying,908,914,6
LPriMk5xy20,,tying,946,954,8
LPriMk5xy20,,tying,983,987,4
LPriMk5xy20,,tying,1037,1043,6
LPriMk5xy20,,tying,1081,1086,5
LPriMk5xy20,,tying,1108,1114,6
LPriMk5xy20,,tying,1120,1124,4
LPriMk5xy20,,suturing,599,605,6
LPriMk5xy20,,suturing,610,613,3
LPriMk5xy20,,suturing,626,634,8
LPriMk5xy20,,suturing,636,641,5
LPriMk5xy20,,suturing,652,655,3
LPriMk5xy20,,suturing,657,661,4
LPriMk5xy20,,suturing,691,693,2
LPriMk5xy20,,suturing,695,698,3
LPriMk5xy20,,suturing,705,708,3
LPriMk5xy20,,suturing,710,715,5
LPriMk5xy20,,suturing,716,720,4
LPriMk5xy20,,suturing,857,867,10
LPriMk5xy20,,suturing,869,875,6
LPriMk5xy20,,suturing,892,895,3
LPriMk5xy20,,suturing,900,904,4
LPriMk5xy20,,suturing,928,930,2
LPriMk5xy20,,suturing,938,942,4
LPriMk5xy20,,suturing,966,970,4
LPriMk5xy20,,suturing,975,980,5
LPriMk5xy20,,suturing,990,996,6
LPriMk5xy20,,suturing,999,1004,5
LPriMk5xy20,,suturing,1007,1019,12
LPriMk5xy20,,suturing,1022,1027,5
LPriMk5xy20,,suturing,1031,1035,4
LPriMk5xy20,,suturing,1062,1065,3
LPriMk5xy20,,suturing,1067,1073,6
LPriMk5xy20,,suturing,1089,1104,15
x301dRwjBt0,cutting,cutting,68,100,32
x301dRwjBt0,cutting,cutting,105,149,44
x301dRwjBt0,suturing,suturing,225,259,34
BWGNKectNVA,cutting,cutting,50,79,29
BWGNKectNVA,cutting,cutting,198,275,77
BWGNKectNVA,tying,suturing,388,399,11
BWGNKectNVA,suturing,suturing,400,423,23
BWGNKectNVA,tying,suturing,424,429,5
BWGNKectNVA,suturing,suturing,430,435,5
BWGNKectNVA,tying,suturing,436,441,5
BWGNKectNVA,suturing,suturing,442,471,29
BWGNKectNVA,tying,suturing,472,477,5
BWGNKectNVA,suturing,suturing,478,513,35
BWGNKectNVA,tying,suturing,514,519,5
BWGNKectNVA,none,suturing,520,525,5
BWGNKectNVA,suturing,suturing,526,533,7
HKhfkcgE0ag,,cutting,70,79,9
HKhfkcgE0ag,,cutting,180,188,8
HKhfkcgE0ag,,tying,222,241,19
HKhfkcgE0ag,,tying,262,287,25
HKhfkcgE0ag,,tying,291,301,10
HKhfkcgE0ag,,suturing,253,261,8
HKhfkcgE0ag,,suturing,305,335,30
toE_4MtsqQM,cutting,cutting,28,48,20
toE_4MtsqQM,,tying,107,111,4
toE_4MtsqQM,suturing,suturing,82,87,5
toE_4MtsqQM,,suturing,97,99,2
toE_4MtsqQM,suturing,suturing,118,140,22
E8UPLNhr2B4,,cutting,9,26,17
E8UPLNhr2B4,,cutting,254,256,2
E8UPLNhr2B4,,tying,202,212,10
E8UPLNhr2B4,,tying,220,231,11
E8UPLNhr2B4,,tying,248,250,2
E8UPLNhr2B4,,suturing,276,277,1
E8UPLNhr2B4,,suturing,284,287,3
E8UPLNhr2B4,,suturing,291,293,2
E8UPLNhr2B4,,suturing,303,304,1
E8UPLNhr2B4,,suturing,308,313,5
E8UPLNhr2B4,,suturing,316,320,4
M2PTmXVatbQ,cutting,cutting,4,12,8
M2PTmXVatbQ,cutting,cutting,38,44,6
M2PTmXVatbQ,,cutting,157,161,4
M2PTmXVatbQ,tying,tying,105,116,11
M2PTmXVatbQ,tying,tying,131,147,16
M2PTmXVatbQ,tying,tying,184,196,12
M2PTmXVatbQ,suturing,suturing,280,303,23
M2PTmXVatbQ,tying,suturing,304,315,11
M2PTmXVatbQ,none,suturing,316,321,5
M2PTmXVatbQ,suturing,suturing,322,327,5
M2PTmXVatbQ,tying,suturing,328,345,17
M2PTmXVatbQ,suturing,suturing,346,387,41
M2PTmXVatbQ,tying,suturing,388,399,11
M2PTmXVatbQ,suturing,suturing,400,416,16
KHrD5_zwTu8,cutting,cutting,56,67,11
KHrD5_zwTu8,suturing,suturing,960,989,29
KHrD5_zwTu8,tying,suturing,990,1003,13
KHrD5_zwTu8,suturing,suturing,1209,1217,8
tBfZ8UkhAG4,tying,suturing,4,9,5
tBfZ8UkhAG4,suturing,suturing,10,21,11
tBfZ8UkhAG4,tying,suturing,22,39,17
tBfZ8UkhAG4,suturing,suturing,40,63,23
JuUFXltasaU,cutting,cutting,6,16,10
JuUFXltasaU,,cutting,275,279,4
JuUFXltasaU,tying,tying,108,131,23
JuUFXltasaU,cutting,tying,132,143,11
JuUFXltasaU,tying,tying,144,165,21
JuUFXltasaU,suturing,tying,205,222,17
JuUFXltasaU,tying,tying,223,269,46
JuUFXltasaU,suturing,suturing,338,343,5
JuUFXltasaU,tying,suturing,344,355,11
JuUFXltasaU,suturing,suturing,356,373,17
JuUFXltasaU,tying,suturing,374,381,7
JuUFXltasaU,,suturing,387,390,3
i2GvmqhU4og,cutting,cutting,47,74,27
i2GvmqhU4og,tying,tying,23,29,6
YXAGt6GtFwE,cutting,cutting,60,116,56
YXAGt6GtFwE,,tying,230,235,5
YXAGt6GtFwE,tying,tying,340,349,9
YXAGt6GtFwE,suturing,suturing,358,382,24
sHZWvYrerEs,cutting,cutting,0,23,23
sHZWvYrerEs,none,cutting,24,29,5
sHZWvYrerEs,cutting,cutting,30,123,93
sHZWvYrerEs,cutting,cutting,483,554,71
sHZWvYrerEs,cutting,cutting,568,583,15
sHZWvYrerEs,cutting,cutting,1207,1233,26
sHZWvYrerEs,cutting,cutting,2208,2216,8
sHZWvYrerEs,cutting,cutting,2272,2288,16
sHZWvYrerEs,cutting,cutting,2332,2358,26
sHZWvYrerEs,tying,suturing,2544,2555,11
sHZWvYrerEs,suturing,suturing,2556,2561,5
sHZWvYrerEs,tying,suturing,2562,2573,11
sHZWvYrerEs,suturing,suturing,2574,2583,9
mMmYtpUschc,cutting,cutting,14,54,40
erUVkDi6KqY,cutting,cutting,48,59,11
erUVkDi6KqY,none,cutting,60,65,5
erUVkDi6KqY,cutting,cutting,66,137,71
erUVkDi6KqY,none,cutting,138,143,5
erUVkDi6KqY,cutting,cutting,144,165,21
erUVkDi6KqY,tying,tying,615,638,23
erUVkDi6KqY,tying,tying,653,705,52
erUVkDi6KqY,,suturing,595,600,5
vtK1XN4ZaU4,cutting,cutting,34,67,33
vtK1XN4ZaU4,,tying,259,262,3
vtK1XN4ZaU4,suturing,suturing,274,291,17
unQH_a-Rm-I,cutting,cutting,60,80,20
unQH_a-Rm-I,tying,tying,155,166,11
zmQpJvYVsi4,cutting,cutting,24,70,46
PC2SAKnlLok,,cutting,30,35,5
PC2SAKnlLok,,cutting,50,55,5
PC2SAKnlLok,cutting,cutting,110,116,6
PC2SAKnlLok,cutting,cutting,119,125,6
PC2SAKnlLok,cutting,cutting,255,265,10
PC2SAKnlLok,cutting,tying,150,160,10
PC2SAKnlLok,tying,tying,165,175,10
PC2SAKnlLok,suturing,tying,180,188,8
PC2SAKnlLok,tying,tying,209,215,6
PC2SAKnlLok,,tying,290,294,4
PC2SAKnlLok,suturing,suturing,200,208,8
PC2SAKnlLok,suturing,suturing,216,226,10
PC2SAKnlLok,suturing,suturing,298,321,23
PC2SAKnlLok,tying,suturing,322,330,8
YLz8sAnLDM8,,cutting,54,87,33
YLz8sAnLDM8,,cutting,120,129,9
YLz8sAnLDM8,,cutting,137,141,4
YLz8sAnLDM8,,tying,110,114,4
YLz8sAnLDM8,,tying,227,233,6
sZzcnDjeUKg,cutting,cutting,49,71,22
sZzcnDjeUKg,suturing,tying,408,413,5
sZzcnDjeUKg,tying,tying,414,429,15
sZzcnDjeUKg,tying,tying,435,446,11
sZzcnDjeUKg,suturing,tying,447,462,15
sZzcnDjeUKg,,tying,510,516,6
kcOqlifSukA,cutting,cutting,130,141,11
kcOqlifSukA,cutting,cutting,150,160,10
kcOqlifSukA,cutting,cutting,180,203,23
kcOqlifSukA,none,cutting,204,215,11
kcOqlifSukA,cutting,cutting,216,281,65
kcOqlifSukA,none,cutting,282,293,11
kcOqlifSukA,cutting,cutting,294,329,35
kcOqlifSukA,none,cutting,330,335,5
kcOqlifSukA,cutting,cutting,336,425,89
kcOqlifSukA,none,cutting,426,470,44
kcOqlifSukA,cutting,cutting,552,593,41
kcOqlifSukA,none,cutting,594,611,17
kcOqlifSukA,cutting,cutting,612,623,11
kcOqlifSukA,none,cutting,624,647,23
kcOqlifSukA,cutting,cutting,648,665,17
kcOqlifSukA,none,cutting,666,700,34
kcOqlifSukA,cutting,cutting,750,767,17
kcOqlifSukA,none,cutting,768,779,11
kcOqlifSukA,cutting,cutting,780,791,11
kcOqlifSukA,none,cutting,792,827,35
kcOqlifSukA,cutting,cutting,828,833,5
kcOqlifSukA,none,cutting,834,850,16
kcOqlifSukA,,cutting,900,905,5
kcOqlifSukA,tying,tying,1340,1348,8
kcOqlifSukA,suturing,tying,1380,1385,5
kcOqlifSukA,tying,tying,1386,1395,9
kcOqlifSukA,tying,tying,1420,1435,15
kcOqlifSukA,tying,tying,1460,1480,20
kcOqlifSukA,suturing,suturing,1260,1289,29
kcOqlifSukA,tying,suturing,1290,1310,20
kcOqlifSukA,suturing,suturing,1320,1340,20
kcOqlifSukA,suturing,suturing,1360,1371,11
kcOqlifSukA,tying,suturing,1372,1380,8
kcOqlifSukA,suturing,suturing,1405,1420,15
kcOqlifSukA,suturing,suturing,1550,1663,113
kcOqlifSukA,tying,suturing,1664,1670,6
kcOqlifSukA,suturing,suturing,1710,1721,11
kcOqlifSukA,tying,suturing,1722,1727,5
kcOqlifSukA,suturing,suturing,1728,1757,29
kcOqlifSukA,tying,suturing,1758,1770,12
L8k75Onag_o,cutting,cutting,6,80,74
L8k75Onag_o,cutting,cutting,138,190,52
L8k75Onag_o,cutting,cutting,220,239,19
L8k75Onag_o,suturing,suturing,90,101,11
L8k75Onag_o,tying,suturing,102,107,5
L8k75Onag_o,cutting,suturing,108,120,12
884CY5zcTr4,,cutting,191,195,4
pZNG2IN5ixo,,cutting,103,108,5
pZNG2IN5ixo,cutting,cutting,158,183,25
QbOhP0qTXM4,cutting,cutting,57,64,7
IzVNghUkxI0,cutting,cutting,172,270,98
IzVNghUkxI0,,cutting,283,287,4
IzVNghUkxI0,cutting,cutting,300,323,23
IzVNghUkxI0,cutting,cutting,340,353,13
IzVNghUkxI0,,tying,567,575,8
IzVNghUkxI0,tying,tying,619,625,6
CfFrwiwgniU,,cutting,213,217,4
CfFrwiwgniU,,cutting,223,227,4
CfFrwiwgniU,cutting,cutting,235,243,8
CfFrwiwgniU,,cutting,248,253,5
CfFrwiwgniU,,cutting,260,264,4
CfFrwiwgniU,,cutting,302,305,3
CfFrwiwgniU,,cutting,336,337,1
CfFrwiwgniU,cutting,tying,154,164,10
CfFrwiwgniU,tying,tying,269,276,7
CfFrwiwgniU,tying,tying,321,331,10
CfFrwiwgniU,,suturing,141,145,4
CfFrwiwgniU,,suturing,372,377,5
CfFrwiwgniU,,suturing,385,388,3
CfFrwiwgniU,,suturing,392,397,5
CfFrwiwgniU,suturing,suturing,403,416,13
CfFrwiwgniU,suturing,suturing,429,449,20
dPvRrcSsc6Y,cutting,cutting,99,111,12
dPvRrcSsc6Y,cutting,cutting,133,183,50
g9lzOYtGLic,cutting,cutting,15,22,7
g9lzOYtGLic,cutting,cutting,34,51,17
ekzZ9azx4N4,cutting,cutting,75,120,45
ekzZ9azx4N4,cutting,cutting,135,180,45
n5o16fYYp-8,cutting,cutting,13,21,8
n5o16fYYp-8,tying,tying,210,217,7
n5o16fYYp-8,tying,tying,225,230,5
n5o16fYYp-8,suturing,suturing,236,247,11
n5o16fYYp-8,tying,suturing,248,259,11
n5o16fYYp-8,suturing,suturing,260,273,13
oewplXxSMrk,cutting,cutting,19,26,7
oewplXxSMrk,,cutting,32,37,5
oewplXxSMrk,cutting,cutting,49,73,24
oewplXxSMrk,cutting,cutting,76,103,27
oewplXxSMrk,cutting,cutting,120,161,41
LbqKFbnZvE4,cutting,cutting,132,320,188
LbqKFbnZvE4,cutting,cutting,371,440,69
LbqKFbnZvE4,cutting,cutting,460,477,17
LbqKFbnZvE4,cutting,cutting,516,522,6
LbqKFbnZvE4,suturing,suturing,850,861,11
LbqKFbnZvE4,tying,suturing,862,903,41
LbqKFbnZvE4,suturing,suturing,904,933,29
LbqKFbnZvE4,tying,suturing,934,944,10
TFwFMav_cpE,tying,tying,60,119,59
TFwFMav_cpE,none,tying,120,125,5
TFwFMav_cpE,suturing,tying,126,131,5
TFwFMav_cpE,tying,tying,132,167,35
TFwFMav_cpE,none,tying,168,173,5
TFwFMav_cpE,tying,tying,226,232,6
TFwFMav_cpE,tying,tying,250,266,16
TFwFMav_cpE,,tying,320,332,12
TFwFMav_cpE,tying,tying,355,367,12
TFwFMav_cpE,tying,tying,440,450,10
TFwFMav_cpE,tying,tying,468,478,10
TFwFMav_cpE,tying,tying,530,543,13
TFwFMav_cpE,,suturing,180,220,40
TFwFMav_cpE,suturing,suturing,240,250,10
TFwFMav_cpE,suturing,suturing,290,313,23
TFwFMav_cpE,none,suturing,332,337,5
TFwFMav_cpE,suturing,suturing,338,350,12
TFwFMav_cpE,suturing,suturing,420,431,11
TFwFMav_cpE,tying,suturing,432,440,8
TFwFMav_cpE,suturing,suturing,455,468,13
TFwFMav_cpE,suturing,suturing,510,530,20
IJuourlriwc,cutting,cutting,60,100,40
IJuourlriwc,tying,tying,150,160,10
IJuourlriwc,tying,tying,180,190,10
IJuourlriwc,suturing,suturing,134,150,16
IJuourlriwc,suturing,suturing,170,180,10
Cczsz7JrUGU,,cutting,4,8,4
Cczsz7JrUGU,,cutting,104,110,6
Cczsz7JrUGU,,cutting,112,124,12
Cczsz7JrUGU,,cutting,130,132,2
Cczsz7JrUGU,,cutting,136,143,7
Cczsz7JrUGU,,cutting,149,154,5
Cczsz7JrUGU,,cutting,159,164,5
Cczsz7JrUGU,,cutting,167,173,6
Cczsz7JrUGU,,cutting,177,180,3
Cczsz7JrUGU,,cutting,183,185,2
Cczsz7JrUGU,,cutting,187,3,-184
Cczsz7JrUGU,,cutting,198,3,-195
Cczsz7JrUGU,,cutting,216,222,6
Cczsz7JrUGU,,cutting,227,257,30
Cczsz7JrUGU,,cutting,261,267,6
Cczsz7JrUGU,,cutting,268,271,3
Cczsz7JrUGU,,cutting,274,290,16
Cczsz7JrUGU,,cutting,292,306,14
Cczsz7JrUGU,,cutting,310,318,8
Cczsz7JrUGU,,cutting,332,352,20
Cczsz7JrUGU,,cutting,359,362,3
Cczsz7JrUGU,,cutting,366,401,35
Cczsz7JrUGU,,cutting,408,416,8
Cczsz7JrUGU,,cutting,418,427,9
Cczsz7JrUGU,,cutting,430,437,7
Cczsz7JrUGU,,cutting,447,450,3
Cczsz7JrUGU,,cutting,457,470,13
Cczsz7JrUGU,,cutting,481,495,14
Cczsz7JrUGU,,cutting,500,504,4
Cczsz7JrUGU,,cutting,508,512,4
Cczsz7JrUGU,,cutting,33,523,490
Cczsz7JrUGU,,cutting,526,552,26
VL_UNwlWd3c,cutting,cutting,106,189,83
VL_UNwlWd3c,none,cutting,190,201,11
VL_UNwlWd3c,cutting,cutting,202,219,17
VL_UNwlWd3c,none,cutting,220,225,5
VL_UNwlWd3c,cutting,cutting,226,237,11
VL_UNwlWd3c,cutting,cutting,265,285,20
VL_UNwlWd3c,suturing,tying,480,485,5
VL_UNwlWd3c,tying,tying,486,500,14
VL_UNwlWd3c,suturing,suturing,322,369,47
VL_UNwlWd3c,tying,suturing,370,385,15
6ywlQxRzZGw,suturing,suturing,96,110,14
EWra7VzEiS4,cutting,cutting,393,412,19
EWra7VzEiS4,cutting,cutting,454,479,25
EWra7VzEiS4,cutting,cutting,606,652,46
StuUjtXj6u8,cutting,cutting,45,51,6
StuUjtXj6u8,cutting,cutting,63,75,12
StuUjtXj6u8,cutting,cutting,84,93,9
StuUjtXj6u8,cutting,cutting,101,111,10
StuUjtXj6u8,suturing,suturing,246,268,22
U_vxJyjmEZ0,cutting,cutting,70,80,10
U_vxJyjmEZ0,suturing,suturing,83,88,5
U_vxJyjmEZ0,tying,suturing,89,94,5
U_vxJyjmEZ0,suturing,suturing,95,130,35
U_vxJyjmEZ0,tying,suturing,131,142,11
U_vxJyjmEZ0,suturing,suturing,143,154,11
U_vxJyjmEZ0,tying,suturing,155,160,5
U_vxJyjmEZ0,suturing,suturing,161,170,9
Uy2fFSuYfpE,cutting,cutting,25,36,11
Uy2fFSuYfpE,cutting,cutting,50,295,245
Uy2fFSuYfpE,cutting,cutting,308,404,96
Uy2fFSuYfpE,cutting,cutting,432,443,11
Uy2fFSuYfpE,cutting,cutting,462,487,25
Uy2fFSuYfpE,suturing,tying,772,777,5
Uy2fFSuYfpE,tying,tying,778,791,13
D11S93t3QiU,,cutting,7,12,5
D11S93t3QiU,,tying,52,55,3
D11S93t3QiU,,suturing,57,61,4
XZleSz21hik,cutting,cutting,60,200,140
ZyWXlbQ8XdI,cutting,cutting,428,566,138
ZyWXlbQ8XdI,cutting,cutting,628,655,27
ZyWXlbQ8XdI,cutting,cutting,677,773,96
ZyWXlbQ8XdI,cutting,cutting,902,926,24
ZyWXlbQ8XdI,suturing,suturing,963,986,23
ZyWXlbQ8XdI,tying,suturing,987,1008,21
1PwQrgU2Lic,cutting,cutting,65,91,26
1PwQrgU2Lic,cutting,cutting,101,114,13
1PwQrgU2Lic,cutting,cutting,142,171,29
1PwQrgU2Lic,,cutting,187,192,5
1PwQrgU2Lic,,cutting,218,221,3
1PwQrgU2Lic,cutting,cutting,261,284,23
1PwQrgU2Lic,,cutting,301,305,4
1PwQrgU2Lic,cutting,cutting,308,331,23
1PwQrgU2Lic,cutting,cutting,345,353,8
1PwQrgU2Lic,cutting,cutting,361,368,7
1PwQrgU2Lic,cutting,cutting,400,421,21
1PwQrgU2Lic,cutting,cutting,427,452,25
1PwQrgU2Lic,cutting,cutting,454,471,17
1PwQrgU2Lic,cutting,cutting,482,489,7
1PwQrgU2Lic,cutting,cutting,492,540,48
1PwQrgU2Lic,cutting,cutting,548,561,13
1PwQrgU2Lic,cutting,cutting,564,575,11
1PwQrgU2Lic,cutting,cutting,644,650,6
1PwQrgU2Lic,cutting,cutting,668,698,30
1PwQrgU2Lic,cutting,cutting,704,726,22
1PwQrgU2Lic,cutting,cutting,839,859,20
1PwQrgU2Lic,,cutting,1081,1085,4
1PwQrgU2Lic,cutting,cutting,1090,1120,30
1PwQrgU2Lic,tying,tying,1171,1179,8
1PwQrgU2Lic,,suturing,1165,1170,5
ILZA2bFVGPE,cutting,cutting,138,146,8
ILZA2bFVGPE,cutting,cutting,191,197,6
ILZA2bFVGPE,cutting,cutting,334,360,26
ILZA2bFVGPE,tying,tying,297,309,12
1gKMtSA6VCY,cutting,cutting,85,640,555
xh9XtKhfzKU,cutting,cutting,440,460,20
xh9XtKhfzKU,cutting,cutting,464,478,14
EswP8VDC85s,cutting,cutting,10,59,49
EswP8VDC85s,tying,suturing,62,67,5
_5OpGzoHEtM,,cutting,300,380,80
